ID;dsc_item;melhor_classif;match_score;Quant. Carct. DSC;Quant. Carct. Classif;Diferença
1;agua sanit; agua sanit;95;10;11;-1
111;agua deion; agua desion;91;10;12;-2
11;destilador de agu; destilador agu;88;17;15;2
347;caixa d agu; caixa d ' agu;88;11;14;-3
97;agua bi desminer; agua desminer;87;16;14;2
40;1 filtro separador d'agu; filtro separador ;86;24;18;6
57;3225 agua destil; agua destil;86;16;12;4
801;reparo da bomba d'agua*; reparo bomba d'agu;86;23;19;4
393;caixa de agu; caixa d ' agu;85;12;14;-2
812;reservatorio de agu; reservatorio de succa;83;19;22;-3
10;boia p caixa d'agua 34; boia caixa d'agu;82;22;17;5
659;lixa d'agu; caixa d'agu;82;10;12;-2
3;agua mineral c20lt; agua mineral nat;80;18;17;1
309;bomba d agu; bomba de vacu;80;11;14;-3
646;lixa d' agu; caixa d ' agu;80;11;14;-3
8;agua mineral 20l; agua mineral nat;79;16;17;-1
149;agua mineral cop; agua mineral nat;79;16;17;-1
287;boia caixa d? agua 12; boia caixa d'agu;79;21;17;4
12;purificador de agu; aparelho purificador de agu;78;18;28;-10
293;boia para caixa d'agua ?; boia caixa d'agu;78;24;17;7
232;anel da bomba d'agu; alicate bomba d'agu;77;19;20;-1
328;bomba d? agu; bomba de vacu;77;12;14;-2
541;filtro separador agua  pac; filtro separador ;77;26;18;8
143;agua mineral 20 litr; agua mineral nat;76;20;17;3
189;agua para autoclav; guarnicao autoclav;76;18;19;-1
326;bomba d'agu; rotor bomba d'agu;76;11;18;-7
644;lixa d agu; caixa d ' agu;75;10;14;-4
832;sensor agu; sensor automo;75;10;14;-4
905;termostato agu; termostat;75;14;10;4
138;agua mineral  20 litr; agua mineral nat;74;21;17;4
330;bomba d?agua mo; bomba d ' agua para mo;74;15;23;-8
810;reservatorio d agua radi; reservatorio de succa;74;24;22;2
124;agua destilada 5ml; agua destil;73;18;12;6
289;boia de 12 para caixa d'agu; boia caixa d'agu;73;27;17;10
372;caixa d'agua 310 litr; caixa d'agua de amiant;73;21;23;-2
375;caixa d'agua 500lt; caixa d'agu;73;18;12;6
878;tampa reservatorio d'agua 1; tampa reservatorio combusti;73;27;28;-1
9;agua mineral 510 ml; agua mineral nat;72;19;17;2
321;bomba d'agua  16; bomba d ' agua para mo;72;16;23;-7
327;bomba dagua pali; bomba d ' agua para mo;72;16;23;-7
800;reparo bomba d'agual10  lote 07; reparo bomba d'agu;72;31;19;12
5;agua destilada 10ml; agua destil;71;19;12;7
115;agua destilada  5ml; agua destil;71;19;12;7
122;agua destilada 5 lt; agua destil;71;19;12;7
288;boia cx d agua 34; boia caixa d'agu;71;17;17;0
333;bomba de agua dobl; bomba de alcool;71;18;16;2
370;caixa d'agua 250 lt; caixa d'agu;71;19;12;7
371;caixa d'agua 3000 l; caixa d'agu;71;19;12;7
374;caixa d'agua 5000 l; caixa d'agu;71;19;12;7
154;agua mineral galao 20 litr; agua mineral nat;70;26;17;9
318;bomba d' agua lote 2; bomba d ' agua para mo;70;20;23;-3
322;bomba d'agua  fiat; bomba d'agua veiculo automo;70;18;28;-10
535;filtro de agua para ponto d; filtro de mascara contra g;70;27;27;0
700;mangueira de alta pressao para agua e ; mangueira alta pressa;70;38;22;16
710;marcador temperatura da agua 1; indicador temperatura e um;70;30;27;3
939;torneira boia para caixa d'agua 12; tampa para caixa d'agu;70;34;23;11
118;agua destilada 10 ml; agua destil;69;20;12;8
123;agua destilada 500ml; agua destil;69;20;12;8
209;agua sanitaria 1lt; agua sanit;69;18;11;7
332;bomba de agua 6909; bomba de vacu;69;18;14;4
539;filtro para agua de barro 3 vel; feltro para apagador de quadro negr;69;31;36;-5
548;filtro separador de agua psd980; filtro separador ;69;31;18;13
652;lixa d'agua 60; caixa d'agu;69;14;12;2
804;reservatorio agua rad lote 33; reservatorio cardiotom;69;29;23;6
170;agua mineral sem gas cop; agua mineral nat;68;24;17;7
312;bomba d agua ducat; bomba d ' agua para mo;68;18;23;-5
363;caixa d'agua  1000 lt; caixa d'agua de amiant;68;21;23;-2
585;inseticida a base d'agu; tinta base agu;68;23;15;8
813;reservatorio de agua do radiador tor; reservatorio cardiotom;68;36;23;13
938;torneira boia cxa d'agua 34; boia caixa d'agu;68;27;17;10
101;agua bidestilada 5 ml; agua destil;67;21;12;9
120;agua destilada 1000ml; agua destil;67;21;12;9
121;agua destilada 5 litr; agua destil;67;21;12;9
128;agua destilada injeta; agua destil;67;21;12;9
144;agua mineral 500ml sgas g; agua mineral nat;67;25;17;8
158;agua mineral litro 991012; agua mineral nat;67;25;17;8
163;agua mineral sgas  500 ml; agua mineral nat;67;25;17;8
166;agua mineral sem gas 20 l; agua mineral nat;67;25;17;8
329;bomba d?agua ; bomba d ' agua para mo;67;13;23;-10
364;caixa d'agua 1000l poliet; caixa d'agua de amiant;67;25;23;2
545;filtro separador de agua fs 19791; filtro separador ;67;33;18;15
565;frange para caixa dagua 25mm; tampa para caixa d'agu;67;28;23;5
597;jarra agu; barra magne;67;9;12;-3
602;jarra inox para agua 1lt; carro aco inox para cur;67;24;24;0
648;lixa d'agua 100; caixa d'agu;67;15;12;3
650;lixa d'agua 120; caixa d'agu;67;15;12;3
651;lixa d'agua 180; caixa d'agu;67;15;12;3
675;luva 50 mm para agu; luva para gol;67;19;14;5
707;marca texto a base d agu; tinta base agu;67;24;15;9
851;servico de solda em registro de agu; servicos de instalacao de estruturas de ac;67;35;43;-8
946;tubo d'agua sien; tubo vacutain;67;16;14;2
963;tubo pvc sold pagua 20mm  4; tubo pvc solda;67;27;15;12
13;radiador de agua de arrefec; alimentador de maquina de serr;66;27;31;-4
377;caixa d'agua de polietileno 2500 lt; caixa d'agua de amiant;66;35;23;12
543;filtro separador de agua  caterpil; separador de placas de bat;66;34;27;7
778;recarga agua pressurizada 10 lt; capacete nao pressurizado  pilot;66;31;33;-2
811;reservatorio da agua do radiador  2; reservatorio agua tipo australiano de 14000 at;66;35;47;-12
27;009068 adaptador para caixa d agua 20mm; tampa para caixa d'agu;65;39;23;16
34;016154 agua destilada 5ml; agua destil;65;25;12;13
106;agua bidestilada 10 ml; agua destil;65;22;12;10
117;agua destilada 1000 ml; agua destil;65;22;12;10
119;agua destilada 1000 ml; agua destil;65;22;12;10
148;agua mineral com gas 500ml; agua mineral nat;65;26;17;9
156;agua mineral galao de 20 litr; agua mineral nat;65;29;17;12
173;agua mineral sem gas 500ml; agua mineral nat;65;26;17;9
360;caixa d agua pvc 1000l; caixa de gordura em pvc;65;22;24;-2
368;caixa d'agua 1000lt poliet; caixa d'agua de amiant;65;26;23;3
380;caixa d'agua fibra 1000 lt; caixa d'agua de amiant;65;26;23;3
401;caixa d`agua 1000 lt; caixa d'agua de amiant;65;20;23;-3
443;chuveiro para agua fr; veiculo para lavar ru;65;21;22;-1
507;disco freio  kombi agu; disco relogio vig;65;22;18;4
519;esguicho metal agu; gancho metal;65;18;13;5
542;filtro separador d agua para volare v8; caixa separadora agua  ole;65;38;27;11
550;filtro separador de agua retro cat 416; separador de placas de bat;65;38;27;11
598;jarra de louca p agu; barra de lata;65;20;14;6
796;registro de agua da cuspid; filtro de agua industr;65;26;23;3
806;reservatorio aguasprinter 313; reservatorio resfri;65;29;20;9
816;reservatorios agua  toyota eti; reservatorio agua tipo australiano de 14000 at;65;30;47;-17
956;tubo ligacao agua vaso pvc; tubo coagulacao ;65;26;17;9
960;tubo pvc 34  agu; tubo pvc solda;65;16;15;1
978;vasilhame de agua 20 litr; vasilhame leit;65;25;15;10
77;adaptador de agua de 34 polegada marron; adaptador de antena de ond;64;39;27;12
137;agua mineral sem gas 500 ml; agua mineral nat;64;27;17;10
168;agua mineral sem gas 500 ml; agua mineral nat;64;27;17;10
300;bolacha de agua e sal pct; mola de valvula de escap;64;25;25;0
313;bomba d agua jcb 214 ; bomba d ' agua para mo;64;21;23;-2
366;caixa d'agua 1000 lts rt; caixa d'agua de amiant;64;24;23;1
382;caixa d'agua fibra 500l c t; caixa d'agua de amiant;64;27;23;4
396;caixa de agua fibra 500 litr; caixa de aco para lix;64;28;22;6
496;cx d'agua polietileno 1000l; tubo polietileno flexi;64;27;23;4
537;filtro de combustivel separador de agua psd980; controle de combustivel para motor a jat;64;46;41;5
544;filtro separador de agua atego 1719; filtro separador ;64;35;18;17
547;filtro separador de agua moto niveladora xcmg; filtro purificador de ar  motor veiculo  automot;64;45;49;-4
647;lixa d' agua ndeg 150; caixa d'agua de amiant;64;21;23;-2
665;lixeira para copos agua e caf; caixa para composica;64;29;21;8
673;luva 40mm para instalacao de agu; areia  filtracao de agu;64;32;24;8
814;reservatorio de agua fiat uno 1213; reservatorio de succa;64;34;22;12
6;agua destilada galao de 5 litr; destilador de nitrogeni;63;30;24;6
7;agua destilada para autoclav; disco ruptura autoclav;63;28;23;5
21;000147 agua sanitaria 2l; agua sanit;63;24;11;13
23;003556 agua destilada 10ml; agua destil;63;26;12;14
63;71100619 bomba da agu; bomba de vacu;63;21;14;7
66;8  agua sanitaria 1 litr; agua sanit;63;24;11;13
335;bomba para agua 34 50mt; bomba para engrax;63;23;18;5
355;caixa d agua de polietileno 310 l; diestearato de polietileno glicol;63;33;34;-1
395;caixa de agua em polietileno 500l; diestearato de polietileno glicol;63;33;34;-1
466;copo descartavel 200ml para agu; coador descartavel caf;63;31;23;8
601;jarra de vidro para agua 1 litr; artigo de vidro para m;63;31;23;8
728;niple entrada de agua bomba de vacu; tampa de succao bomba d'agu;63;35;28;7
876;tampa do reservatorio de agua onibus vw 15190; tampa reservatorio combusti;63;45;28;17
943;tubo agua 60mm 6mt; tubo liga mista met;63;18;20;-2
75;adaptador c flange e anel p caixa d?agu; adaptador de antena de gu;62;39;26;13
131;agua destilada para injecao de 10 ml; molde para injecao de produt;62;36;29;7
142;agua mineral 20 l com o gala; agua mineral nat;62;28;17;11
198;agua raz 1 litr; agua sanit;62;15;11;4
199;agua raz 5l; agulha para ligad;62;11;18;-7
210;agua sanitaria 2 litr; agua sanit;62;21;11;10
302;bolsa agua quente 01lt; bola basquetebol;62;22;17;5
354;caixa d agua de polietileno 1000 lt; caixa d'agua de amiant;62;35;23;12
361;caixa d' agua 310 litros em polietilen; caixa d'agua de aco com colun;62;38;30;8
367;caixa d'agua 1000l polietilen; caixa d'agua de amiant;62;29;23;6
373;caixa d'agua 500 lt  polietilen; caixa d'agua de aco com colun;62;31;30;1
376;caixa d'agua de fibra 500 l redonda c tamp; caixa d'agua de amiant;62;42;23;19
381;caixa d'agua fibra 3000 l; caixa d'agua de amiant;62;25;23;2
383;caixa d'agua polietileno 310l; tubo polietileno flexi;62;29;23;6
385;caixa d'agua polietileno 500l; tubo polietileno flexi;62;29;23;6
386;caixa d'agua pvc 10000 lt; caixa d'agua de amiant;62;25;23;2
387;caixa d'agua pvc 250 litros c; caixa d'agua de amiant;62;29;23;6
402;caixa d`agua de polietileno 5000 litr; diestearato de polietileno glicol;62;37;34;3
495;cx d agua  polietileno  310l ; tubo polietileno flexi;62;29;23;6
632;lavagem de caixa d'agua na farmacia de min; caixa d'agua de amiant;62;42;23;19
655;lixa d'agua n 100; caixa d'agu;62;17;12;5
656;lixa d'agua no100; caixa d'agu;62;17;12;5
774;radiador dagua rg140; irradiador de sang;62;20;19;1
849;servico de munck prestado para retirar caixa d agu; servicos de suporte para transporte aqua;62;50;41;9
869;suporte p copo de agua p 100; suporte de garrafao de agu;62;28;27;1
948;tubo de pvc branco para agua fria 12; tubo de cobre para fim eletr;62;36;29;7
959;tubo pvc 20mm agu; tubo pvc solda;62;17;15;2
76;adaptador cola e rosca 50mm agu; adaptador de lampada soquete  rosca  soquet;61;31;44;-13
79;adaptador de caixa de agua soldavel 20 x 12; adaptador de antena de gu;61;43;26;17
112;agua desmineralizada  galao 5 litr; regua de sinalizacao de transit;61;34;32;2
152;agua mineral copo cxa c 48 un; agua mineral nat;61;29;17;12
216;agua sanitaria cx 12x1; agua sanit;61;22;11;11
250;bebedouro de agua coluna 200 litr; bebedouro agua garrafa;61;33;23;10
320;bomba d'agua  07w121011; bomba d ' agua para mo;61;23;23;0
351;caixa d agua 310 lt c tamp; caixa d'agua de amiant;61;26;23;3
389;caixa d'agua 1000 litros  polietilen; caixa d'agua de aco com colun;61;36;30;6
394;caixa de agua  polietileno 250 l; diestearato de polietileno glicol;61;32;34;-2
599;jarra de plastico resistente para agua 05 litr; composto resistente a agu;61;46;26;20
643;lixa agua 2; caixa d'agu;61;11;12;-1
662;lixa de agua numero 100; bloco de maquina numer;61;23;23;0
663;lixa d' agua n  180; caixa d ' agu;61;19;14;5
720;material de manutencao  lixa d agua  220  ; material para manutencao bens imo;61;42;34;8
817;resina a base de agua incolor 36l ; pintura a base de col;61;34;22;12
853;servicos de limpeza de caixas d'agua nas escol; servicos de agencias de notic;61;46;30;16
52;14642 bolacha agua e s; placa aquisicao de s;60;22;21;1
188;agua pinjecao 5ml; agulha punca;60;17;13;4
194;agua para injecao abd 10 ml; animal para extracao de l;60;27;26;1
237;aquecedor portatil eletrico p agua e liquidos rabo qu; aquecedor nao eletrico de ambi;60;53;31;22
291;boia p caixa d'agua de 12  130050292; boia caixa d'agu;60;36;17;19
323;bomba d'agua motor 71100619; bomba d ' agua para mo;60;27;23;4
324;bomba d'agua no 55225126; bomba d ' agua para mo;60;24;23;1
471;copo descartavel para o consumo de agu; tubo descartavel com iod;60;38;25;13
564;fornecimento e instalacao de tubo de ligacao de agu; amortecedor de vibracao de tubo e c;60;51;36;15
572;garrafa agua mineral 510ml com; agua mineral nat;60;30;17;13
577;garrafa termica para agua5 litr; grade metalica para arquitet;60;31;29;2
657;lixa d'agua no 100; caixa d'agu;60;18;12;6
658;lixa d'agua no 150; caixa d'agu;60;18;12;6
661;lixa de agua 120; caixa d ' agu;60;16;14;2
753;pino central   kombi agu; pino cambio tra;60;24;16;8
870;suporte p galao de agua mineral galao com capacidade para 20 litr; suporte garrafao de agua nao refrigerado com  torn;60;65;51;14
892;te pvc para agua solda  40mm; pinca para uso med;60;28;19;9
2;biscoito agua e s; botao para estof;59;17;17;0
17;bombinha jogar agua no parabris; bomba d ' agua para mo;59;31;23;8
33;013275 lixa d agua med; polia  uso med;59;22;15;7
38;038827 agua sanitaria 5 lt; agua sanit;59;26;11;15
62;724 ducha higienica com registro para controle do fluxo de agua 12; equipamento para controle de iluminacao de ru;59;66;46;20
81;adaptador flange para caixa d'     agua 32 mm; tampa para caixa d'agu;59;45;23;22
102;agua bidestilada amp 10ml; agua destil;59;25;12;13
174;agua oxigenada 10 v; agua adicionada com s;59;19;22;-3
270;biscoito agua e s; botao para estof;59;17;17;0
303;bolsa de agua quente 2 litr; bolsa de alumini;59;27;17;10
365;caixa d'agua 1000 lt polietilen; caixa d'agua de amiant;59;31;23;8
388;caixa d'agua tanque 2500 lt em polietilen; caixa d'agua de aco com colun;59;41;30;11
398;caixa de d' agua fibra de 10000; caixa d'agua de amiant;59;31;23;8
399;caixa de polietileno para armazenamento de agua com capacidade de 2000 lt; unidades de armazenamento de entrada e saida de d;59;73;50;23
474;corante liquido a base de agua 50ml; propelente liquido embalado a base de petrole;59;35;46;-11
497;decalque de olhos a base de agu; equipamento analise de agu;59;31;27;4
532;filtro combustivel separador de agua r 120l10 mb ; filtro de combustivel para bomba injetora   motordiesel;59;49;56;-7
732;outorga para captacao de agua para abastec; forma para corpo de prova para concret;59;42;39;3
748;perfuracao de poco artesiano e sistema de abastecimento de agua   corrego barr; componente do sistema de abastecimento em vo;59;78;45;33
756;poco tubular profundo para captacao de agua subterrane; conduto de ceramica de uso subterrane;59;54;38;16
771;purificador de agua refrigerado de bancadapared; trocador de calor para refrigeraca;59;47;35;12
871;t 25 mm agu; mangu;59;11;6;5
61;6q0 122051am  mangueira inf radiador mangueira d agu; mangueira radiador veiculo automo;58;52;34;18
82;adaptador p cx d agua 25 mm  franj; adaptador de ferramenta man;58;34;28;6
110;agua de coco caixa de agua de coco 1 lt de boa qual; regulador hidraulico de agua de motor a jato de aeronav;58;51;56;-5
177;agua oxigenada 10 volum; agua adicionada com s;58;23;22;1
192;agua para injecao 5 ml agua para injecao 5 ml; maquina para selecao e separacao de f;58;45;38;7
196;agua para injetaveis ampola 5 ml; maquinas para industria de polpa e de papel;58;32;44;-12
246;barra de cano pvc agua ? com 06 metr; barra de aco com secao sextav;58;36;30;6
294;boia para caixa d'agua com bitola de 12; tampa para caixa d'agu;58;39;23;16
358;caixa d agua polietileno de 1000; tubo polietileno flexi;58;32;23;9
390;caixa d? agua polietileno 250 lt; tubo polietileno flexi;58;32;23;9
406;calca de brim leve cor verde agu; calca impermeavel  uso med;58;32;27;5
422;cano de agua soldavel barra 6m 25mm; cuba de aco inoxidavel para p;58;35;30;5
426;cap pvc roscavel branco para agua fria 2; bucha instalacao predial agua fr;58;40;33;7
645;lixa d agua no220; caixa d ' agu;58;17;14;3
653;lixa d'agua em folha grao 100; caixa d'agua de amiant;58;29;23;6
973;uniao pvc para solda 12 agua fr; ferro para solda a g;58;31;21;10
31;011222 caixa d agua de fibra polietileno 1000lt; caixa d'agua de amiant;57;47;23;24
37;028475 filtro d agua wf c2 psa331; filtro de agua industr;57;33;23;10
100;agua bidesmineralizada para autoclave de 05 lt; esfera de sinalizacao para linha de transmica;57;46;46;0
108;agua bidestilada para injecao 10 ml; passadeira para lica e p;57;35;25;10
109;agua boricada 3% 1000 ml; agua boric;57;24;11;13
187;agua p injecao bolsa 01lt; agua mineral nat;57;25;17;8
195;agua para injecao com 1000ml; agulha para punca;57;28;18;10
206;agua sanitaria  embalagem 1l; equipamento embalagem palet;57;28;28;0
276;biscoito salgado tipo agua e sal embalagem de 400 gr; reservatorio agua tipo australiano de 14000 at;57;52;47;5
279;biscoito tipo agua e s; canhao monitor de agua e espum;57;22;31;-9
306;bolsa p agua quente 20 x 30; bolsa parenter;57;27;15;12
353;caixa d agua de fibra de vidro para 500 lts com tampa ; banheira de fibra de vidro de uso domes;57;54;40;14
450;cola branca a base de agua 1 kg; aquecedor de agua a g;57;31;22;9
530;filtro combustivel no original 2ro127177j separador de agu; filtro combustivel  posto abastec;57;58;34;24
570;galao de plastico vazio para agua  capacidade 20l ; torneira de plastico para instalacao hidraul;57;50;45;5
613;joelho de 12  para agua ; aparelho dvd para automo;57;24;25;-1
766;purificador de agua 190010007031056; aparelho purificador de agu;57;35;28;7
835;sensor temperatura agua caminhao bau; indicador temperatura e um;57;36;27;9
850;servico de recuperacao do sistema de bombeamento e tubulacao de agua  caminhao mb l1111; servicos de integracao de sistemas em tecnologia da informacao e comunicacao tic;57;87;81;6
881;tampao marrom para agua de 110; aparelho para purificacao de ;57;30;30;0
893;te pvc para agua solda 50mm 1a l; ferro para solda a g;57;32;21;11
907;tinta acracetagua marinha 18; tinta para carimb;57;28;18;10
944;tubo agua sold 20mmx6 metr; tubo liga mista met;57;26;20;6
949;tubo de pvc para agua fria de 25mm inclusive conexo; estrutura de concreto para linha de ate 725kv inclusiv;57;51;55;-4
32;012443 agua sanitaria 2 litr; agua sanit;56;28;11;17
83;adaptador soldavel para caixa d'agua pvc 25mm x ?; tampa para caixa d'agu;56;49;23;26
107;agua bidestilada ampola c 10 ml; maquina industrial de aplainar m;56;31;33;-2
127;agua destilada frasco com 05 litr; tanque de agua domestico ate 400 litr;56;33;38;-5
191;agua para injecao 10 ml agua para injecao 10 ml; maquina para selecao e separacao de f;56;47;38;9
193;agua para injecao 5ml  agua para injecao 5ml; maquina para selecao e separacao de f;56;44;38;6
317;bomba d agua uno mille way 2012; bomba d ' agua para mo;56;31;23;8
348;caixa d agua 1000 l e polietileno com tamp; caixa d'agua de aco com colun;56;42;30;12
369;caixa d'agua 15000lt  em polietileno com tamp; caixa d'agua de aco com colun;56;45;30;15
427;cap pvc roscavel 34 para agua fria pred; mancal para vagao ferroviari;56;39;29;10
473;copo tipo taca para agua 360 ml crist; fita para maquina de escritori;56;37;31;6
482;corretivo liquido a base de agua tubo de 18 ml; combustiveis e propelentes liquidos a base de petrole;56;46;54;-8
557;flange de pvc de ? marrom agua fr; ferragem de pau  de  carga uso nav;56;33;35;-2
558;flange rosqueavel para caixa d'agua  pvc 40mm; tampa para caixa d'agu;56;45;23;22
569;fundo preparador acrilico base agua 18 litr; espacador rigido para lt;56;43;25;18
587;instalacoes hidraulicasponto de agua frio embutidocaixa de descargalavatori; regulador hidraulico de agua de motor a jato de aeronav;56;75;56;19
603;jarra para agua  capacidade 02 litr; bloco avaliacao capacidade labor;56;35;33;2
681;luva pagua 32mm pvc de corr; luva para procedimento nao cirurg;56;27;34;-7
685;luva pvc soldavel12  agu; tubo pvc solda;56;24;15;9
831;seladora para madeira a base de agua 36 litrosnbr 11702; velador para camara de ion de reator nucl;56;55;42;13
867;suco integral de maracujaaguasuco concentrado de maracuj; estacao industrial de tratamento de agu;56;56;40;16
954;tubo de queda  agua pluvial dn=150 mm; tubo de queda metal;56;37;20;17
19;00000291  agua mineral copo 200 ml; agua mineral nat;55;34;17;17
29;009945 lixa dagua 150; caixa d'agu;55;21;12;9
96;agua 500 ml; agua miner;55;11;11;0
129;agua destilada injetavel 10ml; destilador teflon;55;29;18;11
134;agua em galao lacrado 20 litr; caixa de aco para lix;55;29;22;7
155;agua mineral galao 20 litros somente liqu; terminal grafico de processamento de d;55;41;39;2
211;agua sanitaria 2000ml gala; agulha para ligad;55;26;18;8
213;agua sanitaria a base de cloro frasco de 1 litr; maquina industrial de modelar fio de met;55;47;41;6
272;biscoito de sal tipo agua e sal com 15kg; coletor de lixo  articulado  com cab;55;40;37;3
310;bomba d agua   sandeiro 10 16v ano 2013; bomba d ' agua para mo;55;39;23;16
346;caixa d  agua de polietilenocapacidade 310l; caixa d'agua de amiant;55;43;23;20
357;caixa d agua polietileno c tampa 1000 litros 74251; tanque de agua domestico ate 400 litr;55;50;38;12
384;caixa d'agua polietileno 500 litros com tampa na cor azul; caixa d'agua de aco com colun;55;57;30;27
488;curativo a base de agua hidrogel com 60% agu; curativo hidrogel;55;44;18;26
491;curva 45deg pvc agua fria 20mm ou 34; cuba de pvc para p;55;36;19;17
551;filtro separador de agua vw 15 190 eod e  hd or; feltro para apagador de quadro negr;55;47;36;11
552;filtro separadr de agua e oleo para trator valtra 4x4; filtro purificador de ar  motor veiculo  automot;55;53;49;4
556;flange de pvc ? marrom agua fr; flange para guias de ond;55;30;25;5
595;item 31759 bomba d?agua 5047138; alicate bomba d'agu;55;31;20;11
674;luva 50 mm pagu; luva para gol;55;15;14;1
684;luva pvc roscavel branca para agua fria 112; bucha instalacao predial agua fr;55;43;33;10
803;reservagua radiador hlf8198; radiador ole;55;27;13;14
897;tecido tricoline mista com elastano cor verde agu; acumulador eletrico estatico estacionario chumbo  ac;55;49;53;-4
942;trocar cebolao   kombi agu; rotor bomba d'agu;55;26;18;8
951;tubo de pvc ponta e bolsa soldavel de 25mm p instalacao agua fr; tubo de aco inoxidavel de construcao mecan;55;63;43;20
957;tubo pvc 12 para agua a  6 metr; tubo vidro para laboratori;55;31;27;4
974;uniao pvc para solda 85 mm agua fr; ferro para solda a g;55;34;21;13
22;000926 agua oxigenada 10 volum; agua adicionada com s;54;30;22;8
103;agua bidestilada para injecao esteril  ampola 10 ml; maquinaria para reducao industrial de tamanh;54;51;45;6
161;agua mineral natural sem gas  garrafao com 20 litr; oficina rural com base para acoplamento ao tra;54;50;47;3
165;agua mineral sem gas  agua mineral sem gas galao de 20 litr; maquina industrial de serrar metal  serra de fit;54;59;49;10
212;agua sanitaria = 1 litro =; agua sanit;54;26;11;15
222;agua santasitio do marciositio do paulo nazariotomb; automatico de partida  veiculo automo;54;51;38;13
233;anel sincron 1a  2a  kombi agu; anel sincronizador caixa de marcha  veiculo a    utomo;54;30;55;-25
428;cap pvc soldavel 40 mm para agua fria pred; mancal para vagao ferroviari;54;42;29;13
444;chuveiro simples de pvc  agua fria de 7  chuveiro simples de pvc  agua fria de 7; aquecedor industrial de agua  acima de 400 litros de capacidade ;54;80;65;15
584;higienizacao de caixa d`agua  lote 38; estrado de carga  palete ;54;37;26;11
600;jarra de vidro p agua c tampa  210030032; artigo de vidro para m;54;40;23;17
649;lixa d'agua 100 lixa d'agua 100; boia caixa d'agu;54;31;17;14
660;lixa d?agua no 120; caixa d'agua de amiant;54;18;23;-5
721;medidor de cloro instrumento pratico e seguro para analises de cloro na agua em laboratorios e a c; instrumento de medicao de teor alcoolico para laboratori;54;98;57;41
798;remover instalar manga eixo   kombi agu; removedor tinta impressao digit;54;39;32;7
815;reservatorio em metal com capacidade de 50000 mil litros de agua em formato cilindrico ; reservatorio compensacao de agua de radiador de motor  veiculo automo;54;87;70;17
847;servico de limpeza de caixa d agua de 250 litros com o fornecimento de mao de obra todos os insumos equipamentos e ferramentas necessarias dentro do telh; servicos de leasing ou aluguel de televisores radios gravadores de video e equipamentos e acessorios correlat;54;153;110;43
916;tinta esmalte base agua premium acetinado ; tinta base  prim;54;42;17;25
931;tinta para esponja de carimbo  cor azul composicao agua e glicol; parafuso pressao de madeira com porca  auto   rosc;54;64;51;13
43;105026  lixa abrasiva  tipo d? agua  no 120; tira abrasiva  uso odontolog;53;43;29;14
94;agar padrao pca meio para enumeracao de bacterias em agua para placa de contagem de colon; equipamento especializado para oficina de manutencao e reparo de material de controle de tir;53;89;93;-4
99;agua bi destilada para injecao esteril frasco com 10 ml; presilha de arame para fixacao de farol;53;55;40;15
126;agua destilada e deionizada galao 5 litr; testador isolacao alta volt;53;40;28;12
135;agua minera naturalacondeciana emgalao de 20 litr; minerais naturais e sinte;53;49;26;23
153;agua mineral copo caracteristicas agua mineral natural embalagem copo de 200 ml; maquina para trituracao esmagamento ou moagem de gra;53;79;53;26
178;agua oxigenada 10 volumes  01 litr; tanque de agua domestico ate 400 litr;53;34;38;-4
186;agua oxigenada volume 10 solucao de peroxido de hidrogenio 3%; peroxido de hidrogeni;53;61;22;39
214;agua sanitaria alvejante e desinfetante de uso geral 1 l; maquina industrial de travar dente de serr;53;56;43;13
267;biscoito agua e sal boa qual; sistema de alto  fal;53;28;21;7
281;biscoito agua e sal 370 gr; bico injetor jateamento de are;53;26;31;-5
292;boia p cx d agua 12  haste metal ; conexao hidraulica  material metalico ferr;53;33;43;-10
334;bomba de agua orig p scania huber wabco vw 15190  ivec; bomba de ar pecas e acessori;53;54;29;25
423;cano marrom pvc 20 mm agu; chancelador marca d'agu;53;25;24;1
424;cano marrom pvc agua 50mm ; canhao monitor de agua e espum;53;26;31;-5
456;coluna para deionizador de agua modelo permution capacidade 50 litrosh; aquecedor industrial de agua  acima de 400 litros de capacidade ;53;70;65;5
490;curva 20x45 sold agu; caixa d ' agu;53;20;14;6
492;curva 90 graus em pvc soldavel para agua 25mm; cuba de aco inoxidavel para p;53;45;30;15
540;filtro para agua em bebedouro de 10  e vazao de 2 a 4 m h ; feltro para apagador de quadro negr;53;58;36;22
549;filtro separador de agua r 120 lj onibus vw 15190; filtro purificador de ar  motor veiculo  automot;53;49;49;0
586;inseticida aerosol baixa toxidade com solvente a base de agua sem cfc; peca  acessorio  componente para mop agua  p;53;69;45;24
616;joelho em pvc para agua bitola de 34' rosca de 45; protecao memoria para unidade de processamento de d;53;49;52;-3
654;lixa d'agua g 360 oxido aluminio costado papel; tubo de aluminio de construcao mecan;53;46;37;9
677;luva de correr pvc marrom agua fria 40mm; corrente para carga de aram;53;40;28;12
764;prestacao de servicos com caminhao equipado com pipa ii para abastecimento de agua em comunidades divers; servicos do comercio por atacado prestado por comissao ou   por contratode bens de consumo divers;53;104;98;6
770;purificador de agua refrigerado com capacidade 2 lts de agua gelada 04 lts agua nat; aquecedor de agua ate 100 galoes de capacidade de recuperaca;53;83;61;22
805;reservatorio agua radiador vw up 2014 reservatorio agua radiador  vw up! 2014; reservatorio agua tipo australiano de 14000 at;53;77;47;30
840;servico caixa d`agua de polietileno com tampa 1000 l setop hiddag015; caixa metal com tampa  uso med;53;68;31;37
872;t de 90o cola 1  ?  marrom agua fr; fita de controle de salto de carro automa;53;34;42;-8
873;tacas para  agua material  vidro  transparente410 ml; pasta arquivo moldura transparenc;53;52;34;18
880;tampa uso veicular radiador de agua 82086 lote 01; caixa separadora agua  ole;53;49;27;22
910;tinta acrilica p tecido nao toxica  soluvel em agua 250 ml; fita metalica para encintamento de embal;53;58;41;17
964;tubo pvc soldavel agua fria dn 75mm inclusive conexoes  fornecimento e instalaca; equipamento para solda a gas corte por aquecimento e deme talizaca;53;80;67;13
966;tubo pvc soldavel diametro 32 mm agua fr; tubo de aco inoxidavel de construcao mecan;53;40;43;-3
26;007psfbebedouro de agua coluna galao de 20l aco inoxidavel 127v  ac  ; aquecedor de agua ate 100 galoes de capacidade de recuperaca;52;69;61;8
28;009742 cap pvc crosca p agua fria predial 1; chapa especial para carro e vagao ferroviari;52;43;45;-2
45;108547  tampao  materiaprima pvc tipo soldavel diametro nominal 20mm rede agu; transmissao maritima com tipo de engrenagem de  reducao e reversa;52;77;66;11
55;184  curva pvc 90g crosca pagua fria pred; cuba de louca para p;52;41;21;20
80;adaptador de pvc com flange para caixa dagua 25mm x 34'; adaptador de coletor de admissao de motor a gasolin;52;55;52;3
84;adaptador soldavel para caixa d?agua pvc 50mm x 1 12; adaptador de voz para equipamento de processamento de d;52;52;56;-4
104;agua bidestilada amp 10ml embalagem com 100un; papel picado para embalagem corrug;52;45;35;10
105;agua bidestilada abd injetavel 10 ml; maquina industrial de aplainar m;52;36;33;3
176;agua oxigenada 10 vol 1000ml; agua adicionada com s;52;28;22;6
179;agua oxigenada 10 volumes 1000ml; agua adicionada com s;52;32;22;10
181;agua oxigenada 10 volumes frasco 1 litr; sequencia iniciadora  polimerizacao  primer ;52;39;45;-6
208;agua sanitaria 1 litro agua sanitaria 1 litr; maquina afiar serra  trabalho material metal;52;44;45;-1
268;biscoito agua e sal 200 g; destilador agua equipamento salva  v;52;25;37;-12
269;biscoito agua e sal 400g; bisglicinato de calci;52;24;22;2
356;caixa d agua em polietileno de 1000 litros com sistema de travamento encaixe das tamp; regulador temperatura de oleo  sistema de resfriamento motor aeronav;52;85;69;16
391;caixa d?agua plastica polietileno cor azul 500l; caixa d'agua de aco com colun;52;47;30;17
465;copo de vidro para agua alto transparente capacidade de 415 ml; aquecedor de agua ate 100 galoes de capacidade de recuperaca;52;62;61;1
528;ficha de evolucao  personalizada com marca d?agua cardiolog; balanca de uso humano operada com moeda  ficha ;52;59;48;11
531;filtro combustivel s de agua caminhao vw 15180 e wolker ano 2005; filtro de combustivel para bomba injetora   motordiesel;52;64;56;8
533;filtro compativel para aspirador de agua e po tekna modelo work 60 870027194; filtro de combustivel para bomba injetora   motordiesel;52;76;56;20
546;filtro separador de agua micro onibus volare hmn1119primeira qual; preparador automatico  dissolucao comprim;52;65;42;23
618;joelho pvc para solda 75 mm 90deg agua fr; ferro para solda a g;52;41;21;20
623;joelho roscavel de 90o de 2'' para agua fria solda; bujao de escoamento de oleo de motor a gasolin;52;50;47;3
624;joelho roscavel de 90o de 1'' para agua fria solda; bujao de escoamento de oleo de motor a gasolin;52;50;47;3
719;mastique base de resinas acrilicas para tratamento de trincas em reservatorios de agua potavel bisnaga de 400 gr; maquinas especializadas para fabricacao  de  semicondutorescircuitos microeletronicos e placas de c;52;112;100;12
725;motor submerso refrigerado a agua  nacional  6  90cv220v; mostruario refrigerado de mercad;52;56;33;23
731;oleo essencial de eucalipto citiodora para dissolucao em agua frasco com 140ml; sistemas de geracao e distribuicao de gas fixos ou mo;52;78;54;24
747;perfuracao de 01 um poco profundo no reservatorio de distribuicao de agua r02 avenida antonio carlos 1228; servicos de distribuicao de agua atraves de tubulaca;52;105;53;52
750;pigmento corante de auto poder de tingimento e resistencia p colorir tintas a base d'agu; componente de todo tipo de motor de resfriamento exceto motor primario de missil gui;52;88;85;3
809;reservatorio d agua radiador  2 polos 20192020 placa qxg2931  qxg2935; reservatorio compensacao de agua de radiador de motor  veiculo automo;52;69;70;-1
877;tampa reeserv agua rad hlf8299; tampa reservatorio combusti;52;30;28;2
958;tubo pvc 20 mm para agua fria322261; tubo vidro para laboratori;52;35;27;8
68;8186  te conexao  materiaprima pvc medidas 50 x 34 tipo soldavel de reducao finalidade agu; transmissao maritima com tipo de engrenagem de  reducao e reversa;51;90;66;24
130;agua destilada p autoclave 5 litros agua destilada p autoclave 5 litr; aquecedor industrial de agua  acima de 400 litros de capacidade ;51;69;65;4
160;agua mineral natural s gas recipiente 20lts com devoluca; peca  material para meios auxiliares locomoca;51;56;46;10
169;agua mineral sem gas com 6 garrafas de 1500 ml; maquina industrial de serrar metal  serra de fit;51;46;49;-3
175;agua oxigenada 10 vl frasco 1 litr; maquina tampar  frasco  vasilham;51;34;33;1
190;agua para injecao diluente 10ml  090012792; maquina para fabricacao de leite de soj;51;42;40;2
200;agua sanitaria  1000ml 22826; agua sanit;51;28;11;17
307;bolsa termica para compressa de agua quente em borracha 250ml  tamanho de 215x125cm; material para reforma e reparo de pneus e camaras de ;51;83;54;29
314;bomba d agua mbenz 1418 19901991; bomba d ' agua para mo;51;32;23;9
315;bomba d agua motor vw gol 10 puj4899 1415; tubo nivel agua motor gasolin;51;41;30;11
316;bomba d agua para renault clio 10 16v flex ano 2010; bomba d ' agua para mo;51;51;23;28
343;bucha de reducao pvc sold curta de 50mm x 40mm agu; municao de calibre acima de 30 mm ate 75 mm;51;50;44;6
378;caixa d'agua de polietileno com tampa com capacidade para 250 litros de agu; placa de compensado de madeira a prova de agu;51;75;46;29
455;colar de tomada pvc 32mm 34 agua classe a 170043009611102; oleo de copaiba ver inc 18178 da classe 6810;51;57;45;12
478;corretivo a base de agua 12 ml cx c12 un; acessorio de antena de onda longa media e curt;51;40;47;-7
573;garrafa de agua para geladeira 2 litros material plastico capacidade 2 litros medida 12x7x24 cm; mobiliario material plastico  piscina  jardim   cadeira  m;51;95;59;36
619;joelho pvc roscavel branco para agua fria 90 x 34; rodeiro para vagao ferroviari;51;49;30;19
625;joelho soldavel agua 75 90; aparelho de coagular sor;51;26;25;1
687;luva uniao pvc soldavel ll 20mm pagu; tubo pvc solda;51;36;15;21
701;mangueira de aragua 12 pt300 mangueira de aragua 12 pt300; conexao para mangueira de jardim;51;57;33;24
797;registro de gaveta bruto latao roscavel 2 instalado em reservacao de agua de edificaca; fio e cabo de cobre isolado servico de transformaca;51;86;52;34
882;tampao pvc pra solda bujao 40 mm agua fr; arma auto  propulsionada sobre meia lagart;51;40;43;-3
885;te 90deg soldavel de pvc marrom para agua fria diametro da secao 85 mm; presilha de arame para fixacao de farol;51;70;40;30
887;te de reducao soldavel pvcagua fria50x25mm; componente de mancal de vagao ferroviari;51;42;41;1
919;tinta guache amarelo 500ml composicao resina agua pigmentos carga e conserv; maquina de composicao de texto para escritori;51;75;46;29
922;tinta guache vermelho 500ml composicao resina agua pigmentos carga e conserv; maquina de composicao de texto para escritori;51;76;46;30
926;tinta latex a base d'agua para uso em interiores e exteriores  lata de 18 litr; equipamentos para destilacao de agua para  uso  maritimo  eindustr;51;78;67;11
30;010620 resina bagua telha cor 18 lt; prensa para ensaio eletr;50;35;25;10
74;adapaltoajustavel soldavel para caixa d agua 23mm x 1; tampa para caixa d'agu;50;53;23;30
125;agua destilada de uso profissional para autoclave  090030508; equipamento profissional radiocomunicacao em vhf;50;60;49;11
139;agua mineral  bombona 20 litros  com registro no ministerio da agricult; bomba de asfalto com acessorio de distribuica;50;71;46;25
146;agua mineral com gas  agua mineral com gas embalgem de 500ml recicla; valvula injecao d' agua sistema de combustivel   aeronav;50;68;57;11
151;agua mineral copo 300ml  sem gas cx 48und; caixa metal com tampa  uso med;50;41;31;10
159;agua mineral natural copo 200 ml caixa com 48 copos  meepp; mancal completo com carcaca de tipo espec;50;58;42;16
197;agua pra injecao 10 ml cx c100; mira de inspecao e medica;50;30;26;4
205;agua sanitaria  agua sanitaria  cloro ativo  2 a 25 c 20  litr; tanque de agua domestico ate 400 litr;50;62;38;24
231;analise de agua bruta  conformidade condicionantes do copam  classificacao quimica  parametro toxic; servicos para  a  infraestrutura de tecnologia da informacaoe comunicacao tic  nao classificados em outros top;50;99;111;-12
257;bebedouro eletrico totalmente em aco inox ligado diretamente na rede de agu; atuador eletrico  acionamento de valvul;50;75;40;35
290;boia p caixa d'agua 20 mm boia p caixa d'agua 20 mm; boia caixa d'agu;50;51;17;34
349;caixa d agua 1000 litros   caixa d agua em polietileno de 1000 litros com tamp; aquecedor industrial de agua  acima de 400 litros de capacidade ;50;78;65;13
352;caixa d agua de 10000 litros  caixa d agua em polietileno de 10000 litros com tamp; aquecedor industrial de agua  acima de 400 litros de capacidade ;50;82;65;17
362;caixa d' agua 5000l polietileno caixa d' agua 5000l polietilen; camara de filmagem  poco  agua  petroleo ;50;62;42;20
392;caixa dagua polietileno 250 litros caixa d'agua polietileno 250 litr; polietileno para protecao de oleodut;50;68;37;31
413;camisola tam inf transpassada tecido misto 160 f cores branca e verde agu; camioneta transporte passageiro e carg;50;73;39;34
481;corretivo liquido a base de agua atoxico para correcao de qualquer tipo de escrita frasco c18 ml1695; combinacao de maquinas de gravacao e reproducao desom para uso em escritori;50;100;76;24
483;corretivo liquido a base de agua nao toxico  18ml cx c 12 un; supressor ruido para vela de ignicao  veiculo    automo;50;60;56;4
536;filtro de barro cozido  para filtrar agua capacidade de 8 litros e 2 elementos filtrantes ; aquecedor industrial de agua  acima de 400 litros de capacidade ;50;90;65;25
642;linha 13  boqueirao alto medio e baixo agua preta e iting; apoio de braco para coleta de sang;50;57;35;22
726;mult inseticida aerossol a base de agua com oleo de citronela 450ml  ; pneus e camaras de ar exceto os de aeronav;50;69;43;26
727;nipel pvc  classe a roscavel 34 agua fria pred; camara de filmagem  poco  agua  petroleo ;50;46;42;4
799;reparo bomba d'agua  caminhao mercedes 1214 om 366 ano 9393; bomba d'agua  pecacompon;50;59;25;34
833;sensor de temperatura d agua  fiatdoblo elx 14 ano 2016; servico de perfuracao de pocos de agua e instalacoes de sistemas sep;50;55;69;-14
846;servico de instalacao do condicionado ar split de 60000 btus incluindo tubulacoes de 1 a 4 metros de tubos suporte para fixacao tubo esponjoso fita pvc gas e instalacao no dreno de saida de agu; servicos de instalacao da maquinaria e dos equipamentos medicos profissionaise instrumentos de precisao e o;50;193;108;85
945;tubo cavalete d`agua e68889 pa w20d; cavalete e grade de seguranc;50;35;29;6
977;vasilhame para agua mineral galao com capacidade para 20 litros data de validade estabelecida p; aquecedor industrial de agua  acima de 400 litros de capacidade ;50;95;65;30
20;00003904 luva pvc soldavel 25 mm para agua fria pred; mancal para vagao ferroviari;49;52;29;23
46;10944  te conexao  materiaprima pvc medidas 32mm tipo soldavel finalidade agu; placa de compensado de madeira a prova de agu;49;77;46;31
71;abastecimento de agua  rebobinamento motor monofasico de 5 cv ip 55 220440v 2 polos weg  un; aparelho detector de arma e explosivo por emanacao de vapor  tipo malet;49;91;72;19
145;agua mineral acondicionada em galoes de policarbonato de 20 litros com vasilhame em comodat; conjunto  de anel de contato de  motor  eletrico veiculo automo;49;91;64;27
147;agua mineral com gas  garrafa de 500ml  agua mineral com gas  garrafa de 500ml; lamina de serra de maquina de trabalho em m;49;78;44;34
172;agua mineral sem gas 200ml para entrega embalagem de plastico dentro das regras de comercializaca; carregadeira especial para transporte de terra  fora de estrada ;49;97;65;32
203;agua sanitaria 210072007890006; agua sanit;49;30;11;19
245;barbante de algodao ndeg 04 verde agua  05000166309; barra de aco de secao retangul;49;51;31;20
379;caixa d'agua fibra 1000 l caixa d'agua fibra 1000 l; tampa para caixa d'agu;49;51;23;28
470;copo descartavel para agua suco incolorbranco  300ml pacote com 100 un; guindaste para carro socorro  veiculo automo;49;70;45;25
493;curva em pvc para agua bitolada de 34pol rosca  90 grau; maquina e aparelho para extracao de oleo  gordura veget;49;55;56;-1
498;descida d?agua tipo degrau dn 500 exclusive bota f; disco fatiador de maquina de cortar fri;49;50;40;10
514;eletrodo de ph combinado com corpo de epoxi enchimento em gel para uso em analise de agua conector bnc; filtros de ar e de oleo elementos filtrantes e purificado res exceto os de aeronav;49;102;83;19
583;hidroxido de calcio liquido em suspensao para tratamento de agua  hidroxido de calcio liquido em suspensao para tratamento de agu; conjunto de instrumento  suprimento para tratamento de ferido em combat;49;129;72;57
611;joelho 90o pvc rigido  soldavelp agua fria 50mm; conexao de pvc articulada de mangueira tipo jardim;49;47;51;-4
614;joelho de 90 de pvc rosca agua fria 12 ou 20 mm; conexao de pvc articulada de mangueira tipo jardim;49;47;51;-4
617;joelho liso para agua 25 mm 75561; rolo pressao para copiadora  impres;49;33;36;-3
622;joelho pvc soldavel 90 graus 60 mm para agua fria pred; balao inflavel a ar quente para propaganda aere;49;54;48;6
668;locacao de rede de agua ou esgoto af_102018 46 pg; placa de parede para tom;49;49;25;24
682;luva pvc  soldavel 1  cor marrompagu; luva  uso laboratori;49;36;21;15
760;ponto de agua fria embutido incl tubo de pvc rigido soldavel e conexoes ub; componentes de freio direcao eixo roda e lagarta de vei cul;49;74;60;14
767;purificador de agua  temperatura normalgelada gabinete metalico polipropileno tubo de aco inox; regulador temperatura de oleo  sistema de resfriamento motor aeronav;49;94;69;25
829;saco plastico esterio descartavel de 120ml para coleta de amostra de agua ctiossulfato pacote100; servicos de instalacao de maquinaria e de equipamentos industriais de manfatura e serv;49;96;87;9
836;sensor temperatura agua spin ltz 18 20152016 pwi 0686; sensor para maquina fotocopi;49;53;29;24
875;talao de cobranca de agua contendo 7 sete paginas internas capa e contra capa coloridas4769; aquecedor de agua ate 100 galoes de capacidade de recuperaca;49;91;61;30
896;te soldavel pvc 90 graus 20 mm para agua fr; algodao em pasta para forr;49;43;27;16
928;tinta p carimbo preta componentes agua pigmentos aspectos fisicos liquido aplicacao almofada 40ml; bucha para componente do sistema eletrico  veicu lo automo;49;97;59;38
935;tinta para tecido na cor preta a base de resina acrilica soluvel em agua frascos de 37 ml; material para reforma e reparo de pneus e camaras de ;49;89;54;35
941;torneira plastica de boia convencional para caixa de agua 1  com haste metalica e com balao plastico padrao popul; torneira de plastico para instalacao hidraul;49;113;45;68
965;tubo pvc soldavel p agua fria predial 60mm  6m; tubo  solucao para microbiolog;49;46;31;15
14;00000614agua mineral natural sem gas embalagem de 200 ml; maquinas de embalagem e empacot;48;56;32;24
24;005224 cap pvc sold p agua fria predial 25 mm; conexao de pvc articulada de mangueira tipo jardim;48;45;51;-6
58;39862  luva  materiaprima latao medidas 12 polegada tipo1 simples tipo2 roscavel aplicacao agu; maquina  ferramenta portatil operada por suspensao deslocavel em viga  ;48;94;72;22
59;4*1 estacao de tratamento de agua com capacidade de 08 ls contendo unidade de pre tratamento unidade de microfiltracao e sistema de desinfeccao por misturador esta; servicos de instalacao da maquinaria e dos equipamentos medicos profissionaise instrumentos de precisao e o;48;163;108;55
87;adesivo para resina bisgma hema  dimetacrilato etanol agua metacrilato de acidometracrilico e de poliacrilico e polialceno; haste lateral sistema de pre  aquecimento  de  cilindro de motor a gasolin;48;122;75;47
90;adocante dietetico liquido composto por agua edulcorantes artificiais sucralose e acesulfamek; servicos de promocao e apresentacao relacionados as artes cenicas e outros espetaculos ao v;48;93;92;1
113;agua destilada galao 5 litros agua destilada com condutividade maxima de 13 mscm  galao de 5 litr; equipamentos para destilacao de agua para  uso  maritimo  eindustr;48;97;67;30
133;agua destilada galao 5l devera constar externamente os seguintes dados validade minima de 2 anos e registro no ministerio da saude ; servicos gerais de construcao de estradasexceto elevados ruasviasestradas de ferro e pistas de aterriz;48;131;103;28
226;alicate de pressao visegrip fabricado com aco especial de alta resistenciaideal para fixacao em canos de agua descarga de automoveis e superfici; equipamento especializado para manutencao reparo e inspecaode minas submarinas e bombas de profund;48;144;99;45
280;biscoito tipo agua e sal biscoito  apresentacao tipo agua e sal  pct de 375 g; servicos do comercio por atacado prestado por comissao ou   por contrato de frutas e legum;48;77;91;-14
336;bomba submersa 450 watts para agua limpa  900 5 g 220 v; bomba submersa pecas e acessori;48;55;32;23
350;caixa d agua 310 litros 190035010942120; caixa d'agua de amiant;48;39;23;16
359;caixa d agua polietilino 1000 litros  caixa d agua polietilino 1000 litr; caixa  componentes  caixa sanit;48;72;32;40
397;caixa de agua modelo garrafao 1000 lts  00400010001978; caixa d'agua de aco com colun;48;54;30;24
418;caneta hidrolocor  ponta media e resistente atoxica com tampa fabricada a base de agua c 24 c; capacitor de potencia  tensao nominal acima de 440 v a 12 kv;48;93;61;32
431;carne de frango tipo coxa e sobrecoxa de frangorotulado congelado com adicao de agua de no maximo 6% produto sifima contendo registro do rotul; servicos do comercio por atacado prestado por comissao ou   por contratode produtos farmaceuticos e med;48;142;104;38
452;cola colorida kit c 6 cores nao toxica soluvel em agua acabamento brilhante c 23g ; materiais refratarios e de acabamento superficial contrafo g;48;82;61;21
469;copo descartavel para agua transparente capacidade de 200 ml acondicionado em pacote com 100 unid; carro esmaltado para transporte de refeicao   usohospital;48;97;58;39
476;corretivo liquido a base de agua para erros de escrita manual e datilografica atoxica frasco com 18 ml; servicos de integracao de sistemas em tecnologia da informacao e comunicacao tic;48;102;81;21
485;corretivo liquido secagem rapida a base de agua sem odor atoxico frasco de 18ml caixa com 12 un; reboque especial de construcao para rocha   transportador basculante do tipo fora de estrada ;48;95;94;1
500;destilador de agua capacidade de destilacao de 2 litros hora  garantia minima de 12 meses a partir da data de entreg; servicos de instalacao de maquinaria e de equipamentos industriais de manfatura e serv;48;116;87;29
560;folhas a4 ap75 com duas imagem conta de agua impresso frente e verso tinta azul com dois picot; cartao com microtubo com gel para tiragem sanguinea pesquisa e determinacao de anticorp;48;94;88;6
562;fornecimento e assentamento de tubo cpvc soldavel agua quente dn 89mm 3 inclusive conexo; equipamento de tratamento termico e nao termico de met;48;88;55;33
568;frascos para amostras de agua esterio com tio sulfato de sodio  croning 100 ml; veiculo manipulacao e transporte de  carga explosiva  controle remoto  robo ;48;78;77;1
578;garrafao termico para agua 12 litros garrafao termico para agua capacidade de 12 litros com torneira de boa qualidade e de facil manusei; equipamentos para contramedidas eletronicas  contracontramedidas e de capacidade de reacao rap;48;136;95;41
604;joelho  materiaprima pvc medida 20mm tipo soldavel angulo 90 graus aplicacao para rede de agu; material para reforma e reparo de pneus e camaras de ;48;93;54;39
605;joelho  materiaprima pvc medida 25mm tipo soldavel angulo 45 graus aplicacao para rede de agu; material para reforma e reparo de pneus e camaras de ;48;93;54;39
606;joelho 90   materia prima pvc medidas 50mm tipo1 simples tipo2 soldavel aplicacao agu; materiasprimas diversas florestais e agricol;48;85;45;40
640;limpeza em caixa d'agua de 10000 litros  limpeza interna e xterna com materiais necessarios por conta da contrat; equipamento especializado para oficina de manutencao e reparo de material de controle de tir;48;112;93;19
683;luva pvc rigido agua soldavel azul 25 x 12; ferro para solda a g;48;42;21;21
752;pincel para pintura no12 cabo curto formato redondo composicao ponei indicacao tinta a base de aguavirola de alumini; servicos para  a  infraestrutura de tecnologia da informacaoe comunicacao tic  nao classificados em outros top;48;116;111;5
791;refrigerante ingredientes agua gazeificada acucar extrato de noz de cola cafeina corante caram; equipamento de intercomunicacao e amplificacao de voz exceto de aeronav;48;94;72;22
879;tampa resevatorio agua palio fire economy ano 20112012 10 ano 2016 10 ano 2014 ano 20152016; reservatorio agua tipo australiano de 14000 at;48;91;47;44
890;te interno com conexao central de rosca 12   para mangueira  polietileno  12   uso em rede de agua fria ; instrumentos para medicao e controle de pressao temperaturae um;48;104;64;40
895;te reducao pvc soldavel 90o 32mm x 25mm para agua fria pred; peca  acessorio  componente para mop agua  p;48;59;45;14
920;tinta guache atoxica soluvel em agua cores variadas pote 250 ml; maquinas auxiliares para modelagem e corte de met;48;63;50;13
952;tubo de pvc rigido soldavel agua fria dn25mm 34  27676; cuba de aco inoxidavel para p;48;54;30;24
962;tubo pvc de anel para agua potavel 60mm6m tubo pvc de anel para agua potavel 60mm6m; tubo capilar para coleta de material por catet;48;83;47;36
968;tubo pvc soldavel dn 32mm instalado em ramal ou subramal de agua  fornecimento e instalacao af_122014; servicos de instalacao de pilotis e cimentacao de fundacaoalicerc;48;101;66;35
972;uniao marrom pvc agua fria 20mm tipo solda conforme nbr; unidade movel para tratamento de ole;48;55;37;18
42;101049  plug conexao  materiaprima ferro galvanizado tipo roscavel externo medidas 1 12 polegadas aplicacao isolamento e protecao em rede de agu; servicos de instalacao da maquinaria e dos equipamentos medicos profissionaise instrumentos de precisao e o;47;144;108;36
44;108374  luva  materiaprima pvc medidas 20mm tipo1 simples tipo2 soldavel aplicacao agu; materiasprimas diversas florestais e agricol;47;86;45;41
50;128411  desinfeccao e limpeza de 1 caixa d agua de 500 litros local psf da comunidade de goncalves endereco comunidade de concalv; servicos gerais de construcao de tubulacoeslinhas de comunicacao e de energia de longa distanc;47;129;95;34
60;611 fornecimento e assentamento de tubo pvc rigido soldavel agua fria dn 20 mm 12 inclusive conexo; equipamento de tratamento termico e nao termico de met;47;98;55;43
116;agua destilada  injetavel ampola 10 ml  agua destilada  injetavel ampola 10 ml; maquina duplicadora a tinta  papel termo sensivel  master ;47;78;59;19
150;agua mineral copo 200ml  potavel sem gas copo 200ml  marca de referencia heli; mancal completo com carcaca de tipo espec;47;77;42;35
202;agua sanitaria  teor  2 a 2 50  de cloro ativo   frascos de 1l cada 91021; nitrato de prata solucao ver classe 6810;47;73;41;32
264;bebedouro torre gabinete e tampo em chapa de aco inox fornece agua somente na temperatura gelada >; reboque especial de construcao para rocha   transportador basculante do tipo fora de estrada ;47;98;94;4
308;bomba agua para brisa kombi escolar hlf 9671 bomba agua para brisa  kombi escolar hlf 9671; argola com destorcedor  bomba incendiaria  bomba fins gerais  binc  bfg ;47;90;73;17
325;bomba d'agua para fiat siena anomodelo 20142015 placa pug  4342; bomba d ' agua para mo;47;63;23;40
441;cera liquida incolor  bombona 5 litros composicao emulsao de ceras naturais resina alcalisoluvel preservante fragancia e agu; servicos relacionados com a producao de filmes cinematograficos de televisao e programas de radi;47;124;97;27
449;cola branca  lavavel  nao toxica  adesiva pva a base de agua aprovado pelo inmetro  90 gr; conexao de tubo flexivel de producao de petroleo  injecao de agu;47;89;65;24
480;corretivo liquido 18ml  nao toxico a base de agua dispersantes e titanio secagem rapida com dados de identificacao do produto marca do fabric; servicos relacionados com a producao de filmes cinematograficos de televisao e programas de radi;47;141;97;44
494;curva pvc rigido 25 mm angulo 90 graus para instalacoes prediais de agua fria conforme nbr 9821 e 56; maquinas para industrias de produtos de argila e concret;47;100;57;43
555;fixador dental solucao pronta para uso em processo manual composicao agua 8085% tiosulfato de amonio 510%; artigos diversos para um processamento automatico  de  dadospad;47;105;64;41
591;item 1405 caneta p retroprojetor ponta poliacetal 10mm fina tinta a base de alcool resistente a agu; sistema de onda portadora em linhas de alta tensa;47;99;50;49
615;joelho em pvc para agua de reducao rosca 90 graus bitola de 3 4 x 1 2 poleg; servicos de impressao e de reproducao por meios de gravacaocomissionado ou por contrat;47;75;87;-12
626;junta cavalete d'agua onibus iveco ctl70 2013 pl oqm8876; aquecedor de agua a combustivel liqu;47;56;37;19
635;limpa aluminio tensoativo espessante acidulante corante e agua 500 ml; compnentes de sistema hidraulico de vacuo e  degel;47;69;51;18
703;mangueira para jardim com 50 metros confeccionada em pvc e poliester trancado pressao de agua ate 10 bar acompanhada de 01 jogo de engates rosqueadores e 01 esguich; servicos do comercio por atacado prestado por comissao ou   por contrato de frutas e legum;47;164;91;73
716;marmitex no distrito de olhos d'agua da canastra  110130002; atadeira industrial de rolo de passar roup;47;59;43;16
733;outros servicos de terceiros pessoa juridica  transporte escolar  rota itauna agua parada farias sao pedro km de ida e volta 100 km   turnos manha e tarde  kilometr; servicos de agenciamento de transporte de carga e outros servicos auxiliares de transport;47;164;90;74
759;ponto de agua fria embutido incluindo tubo de pvc rigido roscavel e conexo; equipamentos de ar concicionado aquecimento e pressurizacaode aeronav;47;74;70;4
819;rodo para agua com cabo de madeira tamanho medio borracha dupla  rodo para agua com cabo de madeira tamanho medio borracha dupl; servicos do comercio por atacado prestado por comissao ou   por contratode maquinariaequipamentos e supr;47;127;105;22
834;sensor de temperatura de agua caminhao iveco 170e22  6 cilindro sensor de temperatura de agua caminhao iveco 170e22  6 cilindr; haste lateral sistema de pre  aquecimento  de  cilindro de motor a gasolin;47;126;75;51
837;ser med manip acido acetico 3%  agua destilada qsp 100 ml fr  com 100ml; veiculo manipulacao e transporte de  carga explosiva  controle remoto  robo ;47;71;77;-6
899;tempera guache 250 ml cada unidade soluvel em agua nao toxica com selo de seguranca do inmetro na cor branc; maquinas para fundicao equipamentos e suprimentos  correlat;47;107;60;47
913;tinta base de agua 18 litros 141031004882017; tinta base agu;47;44;15;29
961;tubo pvc 63 pn 750 kpa agua fria predial 110 mm solda; tubo nao metalico para uso em subsol;47;53;37;16
969;tubos nao metalicos rigidos  materiaprima pvc tipo roscavel diametro 34 polegada aplicacao rede de agua comprimento 6 metr; servicos de  arrendamento  mercantil operacional ou locacaode maquinas e equipamentos sem oper;47;122;95;27
41;1265 te soldavel pvc 90 graus50 mm para agua fria predial nbr 5648; sistema de termometria para grao agricola   portatil  informatizado ;46;66;69;-3
65;7975  tubos nao metalicos rigidos  materiaprima pvc tipo colavel diametro 12 polegada aplicacao rede agua comprimento 06 metros medidas em metro corr; maquinas especializadas para fabricacao de recipientes metalicos e equipamentos correlat;46;149;89;60
157;agua mineral garrafa plastica de 600 ml s gas fardo com 12 unidades tipo yara similar equivalente ou de melhor qual; recipientes para coleta de materiais perigosos materiais  eequipamentos de limp;46;115;80;35
180;agua oxigenada 10 volumes 1000ml 572271; agua adicionada com s;46;39;22;17
183;agua oxigenada 1000 ml   570100164; agua adicionada com s;46;34;22;12
252;bebedouro de agua mineral capacidade de xicarasagua em litros 03 litros hora de agua gelada  de acordo com abnt nbr 13972 opcoes de temperatura bivolt; servicos de engenharia durante a fase de construcao e de instalacao de obras de engenharia civil;46;150;97;53
331;bomba de agua   patrol 319    4891252 bomba de agua   patrol 319    4891252; camara de filmagem  poco  agua  petroleo ;46;75;42;33
436;cera liquida  incolor leitoso  composicao a base de agua carnauba e resinas metalizadas  antiderrapante  impermeabilizante  cx c 12 lat; maquinas especializadas para fabricacao de recipientes metalicos e equipamentos correlat;46;135;89;46
451;cola branca liquida a base de agua nao toxica 40grs  acrilex bic faber castell scotch ou superior  ; combinacao de maquinas de gravacao e reproducao desom para uso em escritori;46;99;76;23
457;composicao representativa do servico de instalacao de tubos de pvc soldavel agua fria dn 50 mm instalado em prmada incluisve conexoes cortes e ficacoes para predios   af 102015; servicos de instalacao da maquinaria e dos equipamentos medicos profissionaise instrumentos de precisao e o;46;176;108;68
460;conjunto de bomba submersa 5 hp trifasico 220 v  ou similar  vazao ate 12000 lts d'agu; conjunto de bomba de oleo de motor a gasolin;46;86;45;41
468;copo descartavel para agua branco transparente em polietireno obedecendo as normas da abnt 14865 capacidade 50 ml pacote com 100 un; equipamentos para contramedidas eletronicas  contracontramedidas e de capacidade de reacao rap;46;131;95;36
576;garrafa term de rosca 5 litros corpo em polipropilenoconforme nbr13282 com alca cafe e agu; carro trator de tracao  uso em plataforma de estacao ferrovi;46;90;61;29
596;item 5542 interligacoes da ete  servicos  escavacao mecanica de valas solo com agua profundidade maior que 150 m ate 400 m; servicos do comercio por atacado prestado por comissao ou   por contratode maquinariaequipamentos e supr;46;122;105;17
610;joelho 90gr de pvc rigido soldavel com bitola de 50mm na cor marron para ser utilizada em instalacao predial de agua fr; servicos de engenharia durante a fase de construcao e de instalacao de obras de engenharia civil;46;119;97;22
621;joelho pvc soldavel 90 de40 mm agua de acordo com abnt nbr 564899; caixa d'agua de aco com colun;46;65;30;35
676;luva correr pvc sold pagua fria predial 50 mm  00003847; corrente do cd para impressora off  set;46;55;40;15
689;luvas em latex 100% natural resistente com tensao de ruptura minima atestado ao padrao aql 15 totalmente impermeavel a agua e outros fluidos t; haste lateral sistema de pre  aquecimento  de  cilindro de motor a gasolin;46;142;75;67
743;papel fotografico autoadesivo premium 130gm2 a4 a prova d agua secagem instantanea pacote com 20 folh; servico de perfuracao de pocos de agua e instalacoes de sistemas sep;46;101;69;32
744;papel timbrado 4x0 cores com marca d agua papel compativel ou similar com sulfite 75 gramas folhas avuls; sistema de controle de fumaca de sistema de combustivel de aeronav;46;104;67;37
746;pera d agua  meepp municipio  de tamanho medio cor uniformes firme sem ferimentos eou danos fisicos provenientes do manuseio ou transporte peso medio 130g cada meepp municipi; servicos de manufatura em insumos fisicos que sao propriedade de outrosexceto maquinaria e equip;46;174;97;77
749;pessego em calda pessego em calda composto por pessegos frescos em metades agua acucar xarope de glicosefrutose acondicionados em lata de 450 gr; maquinas especializadas para fabricacao  de  semicondutorescircuitos microeletronicos e placas de c;46;144;100;44
777;reagente quimico solucao de spands sem arsenito para analise de fluor em agua prazo de validade maior ou igual a 1 ano frasco 500ml com certificado de rastre; equipamento especializado para oficina de manutencao e reparo de material de controle de tir;46;157;93;64
787;refrigerante de cola  composto de agua gaseificada acucar extrato de noz de cola cafeina corante caramelo iv acidulante ins 338 e aroma nat; servicos de agenciamento de transporte de carga e outros servicos auxiliares de transport;46;139;90;49
821;sabao em barra composicao sabao de acido graxo de cocobabacu sabao de graxos de sebo sabao de acido de soja cloreto de sodio glicerina silicato de sodio e agu; servicos de promocao e apresentacao relacionados as artes cenicas e outros espetaculos ao v;46;158;92;66
830;selador  aplicacao fundo preparador para parede cor incolor acabamento transparente composicao emulsao acrilica modificada a base de agua utilizacao uso interno e extern; servicos para  a  infraestrutura de tecnologia da informacaoe comunicacao tic  nao classificados em outros top;46;169;111;58
857;suco da polpa de caju sem acucar diluido em agua acondicionado em garrafa contendo 500 ml rendimento minimo de 05 litros  srp  48201458861; componente de sistemas de condicionamento  de  ardo aquecimento e de pressurizaca;46;138;82;56
888;te de reducao pvc soldavel 90 graus 50 mm x 25 mm para agua fria pred; componente de rodeiro para vagao ferroviari;46;69;44;25
891;te pvc agua fria  roscavel e soldavel 25x20mm ou 34 x12; para  raios acima de 242kv;46;55;27;28
911;tinta acrilica vermelha    tinta  acrilica  vermelha  37ml atoxica     soluvel     em     agua secagem rap; maquina duplicadora a tinta  papel termo sensivel  master ;46;106;59;47
912;tinta acrilica vermelha    tinta  acrilica  vermelha  37ml atoxica     soluvel     em     agua secagem rapida  ; maquina duplicadora a tinta  papel termo sensivel  master ;46;111;59;52
929;tinta para almofada de carimbo tubo c 40ml na cor preta pode ser usado em todos os tipos de almofada composicao quimica especial tinta a base de agu; servicos do comercio por atacado prestado por comissao ou   por contratode maquinariaequipamentos e supr;46;148;105;43
930;tinta para carimbo para todos os tipos de almofadas composicao quimica especial tinta a base de agua conteudo 42ml cor vermelho ; servicos do comercio por atacado prestado por comissao ou   por contratode bens de consumo divers;46;128;98;30
950;tubo de pvc para agua fria dn 20de 25 mm soldavel fabricado de acordo com nbr 5648classe 15  6 metr; equipamento especializado para oficina de manutencao e reparo de material de controle de tir;46;99;93;6
975;uniao pvc sold pagua fria predial 20mmun 00009905; unidade especial para trabalho em sonda  utility units ;46;49;56;-7
976;valvula de retencao em bronze de 3 polegada horizontal para agua com pressao de trabalho de 300 psi extremidades com rosca bsp; cartao com microtubo com gel para tiragem sanguinea pesquisa e determinacao de anticorp;46;126;88;38
35;021400007000005   servicos de buffetdescricao contratacao de empresa especializada para prestacao de servicos alimentacao tipo caldos sem bebida alcoolica cardapio agua mineral 03 tipos de sucos naturais acido semi acido e nao acido refrig; servicos do comercio por atacado prestado por comissao o contratode livrosrevistasperiodicos e artigos de escritori;45;239;116;123
48;115086  portal de madeira macica conforme abnt nbr 159302011 para pintura com tinta a base d'agua para porta de 100x210m; barra de aco carbono  para  construcao  mecanica acima de 50m;45;120;62;58
95;agua  sanitaria  embalagem de 01 litro composicao hipoclorito de sodio cloreto de sodio e agua teor cloro ativo 20% a 25%  melhor qualidade ; unidades de propulsao explosiva a combustivel solido de veiculos espaciais e misseis guiados e s;45;140;97;43
98;agua bi destilada 10ml cx c  200 amp 150192; alambique destilador de agu;45;43;28;15
140;agua mineral sem gas  embalagem plastica de 500 ml  com validade minima de 10 meses e data de envase nao superior a 60 d; servicos gerais de construcao de tubulacoeslinhas de comunicacao e de energia de longa distanc;45;120;95;25
162;agua mineral s gas 500ml  c24unid agua mineral s gas 500ml  c24unid; terminal de leitura   cartao inteligente  smart card ;45;67;54;13
164;agua mineral sgas 500ml fardo com 12 garrafas  agua mineral sgas 500ml fardo com 12 garraf; suporte garrafao de agua nao refrigerado com  torn;45;90;51;39
184;agua oxigenada a 10   frasco com 1 litro  agua oxigenada a 10   frasco com 1 litr; suporte garrafao de agua nao refrigerado com  torn;45;81;51;30
201;agua sanitaria  solucao aquosa a base de hipoclorito sodio ou calcio  teor de cloro ativo 2%pp  a 25%pp  acondicionado em frasco plastico opaco de 1 lt56; servicos de impressao e de reproducao por meios de gravacaocomissionado ou por contrat;45;153;87;66
220;agua sanitaria hipoclorito de sodio e agua principio ativo hipoclorito de sodio teor de cloro ativo 20% a 25% pp frasco de 2 litros validade minima 12 meses a partir da data de entreg; servicos do comercio por atacado prestado por comissao o contratode livrosrevistasperiodicos e artigos de escritori;45;183;116;67
240;assentamento tubo pvc com junta elastica dn 50 mm  ou rpvc ou pvc defofo ou prfv  para agu; equipamentos para comunicacao por radio e televisao para aeronav;45;90;65;25
283;bloco de notas em tamanho a5 papel branco gramatura 90 gramas marca d'agua preto e branco com 10 folhas c; conjunto de instrumento  suprimento para tratamento de ferido em combat;45;105;72;33
286;blusa cinturada com tiras para amarrar atras  gola v e manga japonesa  bolso frontal em tecido cretone linhol verde agua  tamanho p  m e g; reboque especial de construcao para rocha   transportador basculante do tipo fora de estrada ;45;138;94;44
297;bola de volei circunferencia 6567 cm peso 260280 gramas em microfibra sem costura miolo substituivel e zero absorcao de agu; elemento injetor de combustivel para bomba injetora de combustivel de motor diesel;45;123;83;40
341;bota de unna bandagem impregnada com pasta a base de oxido de zinco goma acacia glicerol oleo de ricinio e agua deionizada 75cm x 6cm318527; unidades de propulsao explosiva a combustivel solido de veiculos espaciais e misseis guiados e s;45;139;97;42
438;cera liquida para piso principio ativo carnauba composicao basica parafina emulsificante conservante agua e sem perfume teor nao volateis min; maquinaria especializada para armamento e municao e  equipamento correlat;45;141;74;67
453;cola escolar 250gr a base de agua lavav  00200201711; disco para serra de fita para m;45;52;32;20
477;corretivo a base de agua  lavavel atoxico e inodoro igual ou superior a marca toque magico faber castell ou bic enviar amostr; combinacao de maquinas de gravacao e reproducao desom para uso em escritori;45;125;76;49
506;disco  refrigerado    a  agua      diamantado com   furo   de    20mm        para     corte   de c; servicos gerais de construcao de instalacoes ao ar livre    para desportos e laz;45;98;81;17
516;envelope medio timbrado com logo e marca d'agua coloridas 4 cores  185 x 25 cm1853; anel sincronizador caixa de marcha  veiculo a    utomo;45;82;55;27
553;fita de empacotamento transparente 45mm x 45m  composicao dorso de filme de polipropileno biorientado coberta com adesivo acrilico a base de agu; componente mecanico   veiculo de controle  remotode manipulacao de carga explos;45;144;80;64
563;fornecimento e assentamento de tubo pvc rigido soldavel agua fria dn 40 mm 114 inclusive conexoes hidtub020; equipamentos para destilacao de agua para  uso  maritimo  eindustr;45;107;67;40
724;motobomba submersa acoplada em motor eletrico lubrificado a agua com 20 estagios para pocos de 4 potencia de 3 cvmonofasica 2; maquina e aparelho para selecionar peneirar ou separar produtos de ceramica e concret;45;125;86;39
822;sabao em tablete composicaoglicerina  sais inorganicos  coadjulvantes  pigmento e agua  200 gramas  embalagem contendo 05 unidades e notificacao da anvis; licenciamento  de direitos  permanentes  sobre  programas decomputador e locacao de softw;45;153;90;63
889;te de servico integrado articulado com 02 parafusos para ramais prediais de polietileno de de32mm derivados de tubulacao da rede de distribuicao de agua de pvc dn100mm de110mm; servicos relacionados com a producao de filmes cinematograficos de televisao e programas de radi;45;175;97;78
894;te pvc rigido soldavel 50mm fabricacao conforme nbr 5648 com diametro nominal de 50mm na cor marron para ser utilizada em instalacao predial de agua fr; equipamentos para contramedidas eletronicas  contracontramedidas e de capacidade de reacao rap;45;151;95;56
936;tinta plastica composto de resina de pva agua aditivos carga conservante tipo benzotiazol e pigmentos pra aplicacao em papel cartolina gesso ceramica etc na cor azul frascos de 37ml c; servicos de leasing ou aluguel de televisores radios gravadores de video e equipamentos e acessorios correlat;45;183;110;73
25;005824 curva 50 mm ll p agu; cuba de marmore para p;44;27;23;4
47;11342  bucha de reducao  materiaprima pvc diametro nominal 112 x 34 polegadas tipo roscavel aplicacao para rede de agu; reboque especial de construcao para rocha   transportador basculante do tipo fora de estrada ;44;118;94;24
132;agua destilada uso odontologico tipo nao esteril com volume de  05  litros na embalagem devera constar a data fabricacao validade e o numero do lote do produt; servicos do comercio por atacado prestado por comissao ou   por contratode bens de consumo divers;44;158;98;60
182;agua oxigenada 10 volumesfrasco contendo 1000ml registro na anvisa apresentar folder validade minima de 24 meses a partir da data de entreg; equipamentos para contramedidas eletronicas  contracontramedidas e de capacidade de reacao rap;44;139;95;44
215;agua sanitaria com 1000 ml 170675004351083; agua adicionada com s;44;42;22;20
224;alcool saneante 70% frasco de 1 litro alcool etilico hidratado na concentracao de 70 inpm 70 % em peso diluido em agua deionizada indicado como antisseptico topico para ser usado na pel; controle giroscopico  direcional  para  superficieacionado por sistema hidraulico para aeronav;44;185;95;90
228;almofada tintada almofada tintada para carimbo no 03 com tecido de longa duracao em estojo com tampa plastica medias 67cm composicao resina agua glicois e corantes na cor azul; maquinas especializadas para fabricacao  de  semicondutorescircuitos microeletronicos e placas de c;44;175;100;75
282;bisnaga de corante liquido  50 ml pigmento corante de alto poder de tingimento e resistencia para colorir tintas base d'agua  rendimento aproximadamente ate 1 bisnaga por galao de 36 litros de tinta  cor amarel; equipamento especializado para oficina de manutencao e reparo de material de controle de tir;44;210;93;117
319;bomba d'agua   ford currier para ford currier l 16 total flex 20102010; bomba manual de encher pneu  veiculo automo;44;70;44;26
425;canudo plastico flexivel para agua ou suco 21cm x 6mm branco  pct com 100 unidades embalado individ; carro trator de tracao  uso em plataforma de estacao ferrovi;44;99;61;38
434;carro para limpeza construido em polipropileno com balde espremedor de 30 litros kits de limpeza liquido e po placa de sinalizacao pa balde espremedor com divisao de agua limpa e suj; instrumentos para medicao de fluxo de liquido e  gas  nivelde liquidos e de movimentos mecan;44;182;93;89
484;corretivo liquido material a base de agua secagem rapida frasco c 18 ml cx com 12 un  marca de referencia faber castel bic maripel; servicos gerais de construcao de estradasexceto elevados ruasviasestradas de ferro e pistas de aterriz;44;130;103;27
503;detergente 500ml  com tensoativos anionicos sequestrante derivados de isotiazolinonas espessante corante fragrancia e agua componente ativo lin; servicos gerais de construcao de estradasexceto elevados ruasviasestradas de ferro e pistas de aterriz;44;143;103;40
527;ferro a vapor com lampada piloto spray vapor vertical reservatorio de agua de 270 ml visivel seletora de intensidade de vapor potencia de 1200w consumo de 96 kwh tensao 110v; servicos do comercio por atacado prestado por comissao ou   por contratode bens de consumo divers;44;173;98;75
538;filtro de combustivel separador de agua no 158437 motor cumins chassi n7ah13654 maquina marca retroescavadeira pa carregadeira case modelo 580m ano 2007; filtro de combustivel para bomba injetora   motordiesel;44;152;56;96
554;fixador celular 100ml composicao alcool etilico polietileno clicol agua purificada e propelente butano para fixar o esfregaco celular na lamin; filtros de ar e de oleo elementos filtrantes purificadores de motores de aeronav;44;142;81;61
559;folha timbrada tamanho a4  75gm2  com logo e marca d'agua coloridas 4 cores2322; transmissao maritima com tipo de engrenagem de  reducao e reversa;44;79;66;13
575;garrafa para agua em vidro transparente liso em formato retangular medindo aproximadamente 18 x 8 x 23 cm capacidade 15 litros tampa com mecanil; equipamentos para contramedidas eletronicas  contracontramedidas e de capacidade de reacao rap;44;144;95;49
593;item 1 caminhao pipa 6000 l peso bruto total 13000 kg distancia entre eixos 480 m potencia 189 cv inclusive tanque de aco para transporte de agua capacidade 6m3; caminhao especial de construcao para transporte de terr;44;160;56;104
594;item 22012 colilert substrato cromogenico enzimatico metodo rapido para deteccao de coliformes totais e escherichia coli em agua com confirmacao em 24 h; equipamento especializado para oficina de manutencao e reparo de material de controle de tir;44;152;93;59
607;joelho 90 graus com bucha de latao pvc soldavel dn 25mm x 12? instalado em ramal ou subramal de agua  fornecimento e instalacao af_122014 ; variador de velocidade  motor   ventilador  bomba  acionamento regula;44;138;70;68
608;joelho 90 graus com bucha de lataopvcsoldaveldn 25 mmx 12 instalado em ramal ou subramal de aguafornecimento e instalacao  af_122014 vila un; servicos gerais de construcao de estradasexceto elevados ruasviasestradas de ferro e pistas de aterriz;44;140;103;37
612;joelho 90o pvc soldavel  azul c bucha de latao  agua fria  nbr 5648   25 x   ; espoleta ogiva mecanica  anti  carro    eom   fac ;44;77;51;26
667;locacao de estruturas  locacao de palco em estrutura de aluminio q30 ou q50 em formato de  duas  ou  uma  agua tamanho 08 x 06 m  di; servicos para  a  infraestrutura de tecnologia da informacaoe comunicacao tic  nao classificados em outros top;44;132;111;21
679;luva de pvc rigido soldavel 20mm fabricacao conforme nbr 5648 com diametro nominal de 20mm na cor marrom para ser utilizada em instalacao predial de agua fr; equipamentos para contramedidas eletronicas  contracontramedidas e de capacidade de reacao rap;44;156;95;61
709;marcador para escrita em lamina de retroprojetor com ponta de 20 mm resistente a agua lavavel em alcool nas cores preta azul vermelha cx com 12 un; servicos de impressao e de reproducao por meios de gravacaocomissionado ou por contrat;44;146;87;59
739;pao frances unidades de 50g preparado com farinha de trigo especial acucar leite sal e agua com casca de cor uniforme castanhodourado macia miolo de cor brancocreme de textura macia e granulacao fina entrega di; equipamento especializado para oficina de manutencao e reparo de material de controle de tir;44;210;93;117
902;tenda balcao 3 x 3m  chapeu de bruxa com calha para escorrimento de agua  com cobertura em lona auto extinguivel  anti  chama  na cor branc; maquina e aparelho para selecionar peneirar ou separar produtos de ceramica e concret;44;139;86;53
908;tinta acrilica 120 g vermelho  soluvel em agua atoxica tinta acrilica 120 g vermelho  soluvel em agua atox; resistencia  fusivel de ceramica  bobina de ignicao  veiculo automo;44;106;68;38
918;tinta guache  composicao resina viniculaaguapigmentocargas e conservante  cor rosa  aplicacao pintura a pincel em papelcartao e cartolina frasco c250 ml; servicos gerais de construcao de instalacoes ao ar livre    para desportos e laz;44;152;81;71
924;tinta guache composicao resina viniculaaguapigmentocargas e conservantes cores variadas aplicacao pintura a pincel em papelcartao e cartolina frasco c250ml; servicos gerais de construcao de instalacoes ao ar livre    para desportos e laz;44;155;81;74
933;tinta para tecido cor verde folha a base de resina acrilica nao toxicas e soluveis em agua prontas para uso resistente a lavagens fixacao a frio 250 ml; servicos de promocao e apresentacao relacionados as artes cenicas e outros espetaculos ao v;44;151;92;59
36;021900001700112  joelho 90 graus com bucha de latao pvc soldavel dn 25mm x 12 instalado em ramal ou subramal de agua  fornecimento e instalaca; variador de velocidade  motor   ventilador  bomba  acionamento regula;43;142;70;72
49;128375  desinfeccao e limpeza de 08 caixas d'agua de 1000 litros local em maria aparecida brandao vieira endereco avenida santa rita 90 santa rit; aquecedor de agua ate 100 galoes de capacidade de recuperaca;43;145;61;84
67;83 composicao representativa do servico de instalacao de tubos de pvc soldavel agua fria dn 25 mm instalado em ramal subramal ramal de distribuicao ou prumada inclusive conexoes cortes e fixacoes para predios af_102015; servicos de instalacao da maquinaria e dos equipamentos medicos profissionaise instrumentos de precisao e o;43;218;108;110
69;89366 sinapi joelho 90 graus com bucha de latao pvc soldavel dn 25mm x 34? instalado em ramal ou subramal de agua  fornecimento e instalacao af_122014; variador de velocidade  motor   ventilador  bomba  acionamento regula;43;150;70;80
70;89522  joelho 90 graus  joelho 90 graus pvc serie r agua pluvial dn 75 mm junta elastica fornecido e instalado em ramal de encaminhamento af_122014; servicos de engenharia durante a fase de construcao e de instalacao de obras de engenharia civil;43;147;97;50
78;adaptador de caixa d agua 50mm  adaptador soldavel com anel para caixa d agua feito com pvc de alta durabilidade qualidade superior a tigre ou amanc; equipamento especializado para oficina de manutencao e reparo de material de controle de tir;43;148;93;55
91;adocante dietetico aspecto liquido transparente constituido de agua edulcorantes artificiais sacarina sodica ciclamato de sodio com bico dosador frasco com 200ml; unidades de propulsao inertes a combustivel solido de veiculos espaciais e misseis guiados e seus c;43;161;100;61
185;agua oxigenada a 10 volumes 150216035737009; agua adicionada com s;43;43;22;21
311;bomba d agua  14   micro lo 712 mb 2005  hmg 6784  educacao  lote 14; cabeca de guerra  anti  carro  cab  ac ;43;68;40;28
400;caixa de revelacao de filmes radiograficos odontologicos camara escura contendo recipientes com  tampa para agua revelador e fixador confeccionada em material de facil limpeza e passivel de desinfecca; servicos relacionados com a producao de filmes cinematograficos de televisao e programas de radi;43;200;97;103
408;calculadora protecao contra agua e poeira 12 digitos tipo mesa conformidade com a iec 60529 ip 54 34h x 139w x 1875dmm  acao soc; equipamentos para contramedidas eletronicas  contracontramedidas e de capacidade de reacao rap;43;128;95;33
421;caneta p  quadro branco  na cor azulponta 2 0mm  para escrita em acetato  tinta a base de alcool com secagem rapida e resistente a agua e umidade  ideal para transparncias 17851; equipamentos para contramedidas eletronicas  contracontramedidas e de capacidade de reacao rap;43;177;95;82
447;cloro super forte com teor de cloro ativo de 39 a 56  pp composicao  hipoclorito de sodio corante e agua o rotulo deve conter data de validade dados do fabricante principio ativo composicao do produto e conteudo liquido com validade min; servicos do comercio por atacado prestado por comissao o contratode livrosrevistasperiodicos e artigos de escritori;43;236;116;120
448;coffee break  fornecimento de coffee break considerando evento com preco por pessoa cafe leite agua 2 tipos de suco 2 tipos de refrigerantes  1 dietetico  3 tipos de biscoitos finos pao de metro cesta de paes variados torradas 3 tipos d; servicos do comercio por atacado prestado por comissao o contratode livrosrevistasperiodicos e artigos de escritori;43;236;116;120
487;creme hidratante para o corpo embalagem com 500 ml composicao agua alcool cetoestearilico oleo mineral vaselina solida ureia dimeticona 20010; painel de papelao papel empregado em construcao e materiaisde isolamento term;43;141;78;63
510;ducha higienica com registro para controle de fluxo de agua 12  fornecimento e instalacao unidade b ducha higienica com registro para controle de fluxo de agua 12ss  fornecimento e instalacao unidade basica de saudesss; equipamentos para contramedidas eletronicas  contracontramedidas e de capacidade de reacao rap;43;218;95;123
574;garrafa de agua squeeze  garrafa de 500 ml cores sortidas altura 20 cm largura 65 cm comprimento65 cm peso 180 g; combinacao de maquinas de gravacao e reproducao desom para uso em escritori;43;112;76;36
581;gol 16 04 portas geracao v ano 2012 e modelo 2013  placa hlf9718 tampa reservatorio de agua ; outros servicos de transporte rodoviario de carg;43;92;49;43
592;item 1580 corretivo liquido para papel a base de agua frasco com 18 ml alta qualidade  igual ou superior ao toque magico caixa com 12 un; servicos de engenharia durante a fase de construcao e de instalacao de obras de engenharia civil;43;136;97;39
609;joelho 90 graus pvc soldavel dn 25mm instalado em ramal ou subramal de agua  fornecimento e in joelho 90 graus pvc soldavel dn 25mm instalado em ramal ou subramal de agua  fornecimento e instalaca; servicos de instalacao da maquinaria e dos equipamentos medicos profissionaise instrumentos de precisao e o;43;196;108;88
620;joelho pvc soldavel 45deg 32 mm para agua fria predial joelho pvc soldavel 45deg 32 mm para agua fria pred; aparelho de tracao para locomotiva e vagao ferroviari;43;106;54;52
639;limpeza e conservacao  controle de pragas desinsetizacao desratizacao descupinizacao limpeza e higienizacao de caixas e reservatorios de agua desalojamento de pombos e morcegos  cec centro comunitario de educacao e cidadania rua visconde d; servicos de instalacao da maquinaria e dos equipamentos medicos profissionaise instrumentos de precisao e o;43;239;108;131
717;massa corrida lata de 18 litros na cor branca com rendimento ate 80 m2 por demaocomposicao resina vinilica cargas minerais hidrocarbonetos alifaticos espessantes microbicidas nao metalicos e agu; servicos de promocao e apresentacao relacionados as artes cenicas e outros espetaculos ao v;43;194;92;102
718;massa corrida metodo aplicacao com espatula e desempenadeira composicao basica resina acrilica solubilidade agua aplicacao imperfeicao superficie externa e interna para pintura lata de 18 litr; equipamento especializado para oficina de manutencao e reparo de material de controle de tir;43;192;93;99
786;refrigerante composto de extrato de guarana agua gaseificadaacucarextrato de semente de guaranacorantes artificiais livre de sujidades parasitas e larvas acondicionado em garrafa pet de 2 litros marca sugerida antarc; servicos de engenharia durante a fase de construcao e de instalacao de obras de engenharia civil;43;216;97;119
794;refrigerante tipo guarana  02 litros  refrigerante em garrafa pet  tipo guarana embalagem com 02 litros  agua gaseificada com aroma natural de guarana nao alcool; servicos para  a  infraestrutura de tecnologia da informacaoe comunicacao tic  nao classificados em outros top;43;161;111;50
823;sabao enzimatico  enzima protease enzima lipase enzima alfa amilase nonilfenol etoxilado 95 eo alcool isopropilico estabilizantes corante essencia conservnte e agua deionizada ; maquinas especializadas para fabricacao  de  semicondutorescircuitos microeletronicos e placas de c;43;176;100;76
865;suco em po abacaxi sache 25 g adocado 1 lt suco em po abacaxi sache 25 g adocado 1 lt e tenha especificado em sua embalagem bater com agua ou leit; servicos para  a  infraestrutura de tecnologia da informacaoe comunicacao tic  nao classificados em outros top;43;146;111;35
921;tinta guache colorida atoxica lavavel soluvel em agua composicao polimero vinilico carga mineral tensoativos conservantes e pigmento caixa com 06 unidades de 15 ml cada um; equipamentos para contramedidas eletronicas  contracontramedidas e de capacidade de reacao rap;43;171;95;76
923;tinta guache composicao resina viniculaaguapigmentocargas e conservantes  aplicacao pintura a pincel em papelcartao e cartolina frasco c250ml   cores vari; vagao construido especialmente para servico pesado  transporte de minerio e pedr;43;154;81;73
955;tubo em pvc25mm6msoldavel rigido para agua fria  fabricacao conforme nbr 5648  com diametro nominal de 25mm  na cor marron  para ser usado em instalacoes prediais  medindo 06 metr; servicos do comercio por atacado prestado por comissao o contratode livrosrevistasperiodicos e artigos de escritori;43;179;116;63
967;tubo pvc soldavel dn 50mm x 6m para agua fria nbr5648 42256; componente de rodeiro para vagao ferroviari;43;59;44;15
16;127843372212  limpeza  de caixa d agua  limpeza de caixa d?agua 2000 litros realizar a limpeza desinfeccao com a solucao de hipoclorito de sodio naclo a 25% conforme norma dos orgaos compet; servicos para  a  infraestrutura de tecnologia da informacaoe comunicacao tic  nao classificados em outros top;42;189;111;78
92;adocante frasco de 100 ml  adocante liquido com os seguintes ingredientes agua sorbitol edulcorantes artificiais ciclamato de sodio e sacarina sodica conservantes acido benzoico metilparbeno valor calorico 0007kcal 0 carboidrat; servicos de leasing ou aluguel de televisores radios gravadores de video e equipamentos e acessorios correlat;42;227;110;117
243;bacia plastica transparente 86 l  com bico direcionador de agua escala medidora de volume e pega anatomica e segura feita em plastico resistente e com um design moderno capacidade 86 lt; equipamento especializado para oficina de manutencao e reparo de material de controle de tir;42;185;93;92
278;biscoito sequilhos com amido de milho acucar cristal agua farinha de trigo enriquecida com ferro e acido folico margarina de palma leite em po integral ovo integral em po fermentos quimicos sal aroma identico ao natural de baunilh; servicos de instalacao da maquinaria e dos equipamentos medicos profissionaise instrumentos de precisao e o;42;230;108;122
299;bola lisa para propriocepcao de coracao ideal para   fisioterapia    exercicios de forca  coordenacao e propriocepcao    uso na agua ou piscina  hidroterapia e hidroginastica    melhora a circulacao sanguinea    ideal para mass; controle giroscopico  direcional  para  superficieacionado por sistema hidraulico para aeronav;42;227;95;132
409;caminhao carroceria iveco tector 170 e22 ano 2014 placa pvo1115 chassi 93za1rgh0e8927064radiador de agu; caminhao especial de construcao para transporte de terr;42;103;56;47
411;camisa confeccionada em malha pv ou pp confortavel e que garanta a qualidade do colorido na estamparia cor verde agua manga com dobra na manga e gola na cor branca para crianca de 11 e 12 ; servicos de engenharia durante a fase de construcao e de instalacao de obras de engenharia civil;42;188;97;91
416;caneta hidrocor ponta media e resistente tampa antisfixiante vedacao adequada pavio acetato corpo e tampa resina termoplastica ponta fina de poliester base de agua atoxica lavavel cores viva caixa c12; servicos de engenharia durante a fase de construcao e de instalacao de obras de engenharia civil;42;200;97;103
454;cola liquida 500ml com bico com espatula aplicadora comtampa adicional no tubo que evita vazamento e com registro no conselho regional de quimica atoxicocomposicao resina pva e agua 38237; cartao com microtubo com gel para tiragem sanguinea pesquisa e determinacao de anticorp;42;187;88;99
499;desinfetante liquido  composicao  tensoativo nao ionico tensoativo cationico preservante corante perfume e agua perfume de lavanda e educalipto  acondicionado em frasco plastico de 2 lt1758; equipamentos para contramedidas eletronicas  contracontramedidas e de capacidade de reacao rap;42;189;95;94
636;limpador multiuso concentrado para limpeza pesada composicao linear alquil benzeno alcalinizante coadjuvante conservante fragrancia e agua embalagem de500 ml semelhante as marcas veja cif e ype notificado pela anvis; equipamento especializado para oficina de manutencao e reparo de material de controle de tir;42;215;93;122
672;lustra movelpoliflor lavanda caixa com 12 unidade composicao cera microcristalina cera de parafina silicone emulsificante espessante derivado de isotiazolinona solventes alifaticos fragrancia e agu; servicos gerais de construcao de tubulacoeslinhas de comunicacao e de energia de longa distanc;42;197;95;102
702;mangueira pvc cristal 34 3 0mm mangueira linha cristal sao recomendadas para transporte de ar agua ou fluidos  inorganicos tais como acido e base media pressao sao utilizados principalmente para medicao de nivel em construcao civil e irrigaca; servicos do comercio por atacado prestado por comissao ou   por contratode bens de consumo divers;42;242;98;144
755;plug de pvc roscavel de 34  pn 750 kpa para sistemas prediais agua fria  caracteristicas tecnicas e fabricacao de acordo com abnt nbr 5648 de 2010 e abnt nbr 5626 de 1998 ; servicos de engenharia durante a fase de construcao e de instalacao de obras de engenharia civil;42;171;97;74
763;preparado liquido para refresco de frutasmaracujaconcentrado integral bebida nao fermentada com 30  de polpa da fruta com concentracao para 6 a 8 partes de agua embalagem de 500ml igual ou superior o dafrut; servicos para  a  infraestrutura de tecnologia da informacaoe comunicacao tic  nao classificados em outros top;42;206;111;95
788;refrigerante de cola preparado com agua carbonatada   acucar   cafeina   extrato de noz de colaacidulante ins 330  conservador ins 211  corante ins 110  acidulante ins 338  conservador ins 211; servicos do comercio por atacado prestado por comissao o contratode livrosrevistasperiodicos e artigos de escritori;42;192;116;76
795;refrigerante zero acucar a base de extrato de cola composto de guarana agua gaseficada adocantes isento de corantes artificiais livre de sujidades parasitas e larvras condicionado em garrafas pet com tampa der; servicos gerais de construcao de estradasexceto elevados ruasviasestradas de ferro e pistas de aterriz;42;209;103;106
818;revelador revelador  composicao agua dietileno glicol hidroquinona e carbonato de potassio forma fisica liquido  indicado para o processamento manual de filmes radiograficos dentais intraorais embalagem c 500ml; controle giroscopico  direcional  para  superficieacionado por sistema hidraulico para aeronav;42;210;95;115
852;servicos comuns de encanador ou bombeiro hidr servicos comuns de encanador ou bombeiro hidraulico tais como verificar instalacoes hidraulicas efetuar manutencao de sistemas usados para agua potavel esgoto e drenagem em sistemas de encan; servicos gerais de construcao de tubulacoeslinhas de comunicacao e de energia de longa distanc;42;236;95;141
863;suco de tangerina integral pasteurizado alimento natural liquido integral pasteurizado sem adicao de conservantes agua ou acucar obtido pelo beneficiamento de tangerinas sadias o produto devera conter registro no mapa cumprindo legislacao vig; servicos de leasing ou aluguel de televisores radios gravadores de video e equipamentos e acessorios correlat;42;242;110;132
866;suco em po sabores variados contendo acido ascorbico c diluicao de 9l de agua por 1 kg de po acondicionado em embalagem integra atoxica resistente vedada hermeticamente e limpa validade minima de 06 mes; servicos relacionados com a producao de filmes cinematograficos de televisao e programas de radi;42;202;97;105
900;tempera guache azul  com 6 unidades de 250 gramas composicao resina  agua  pigmentos  carga e conservantes tipo benzotiazol  com dados de identificacao do produto  marca do fabricante e peso liqu; unidades de propulsao inertes a combustivel solido de veiculos espaciais e misseis guiados e seus c;42;195;100;95
15;00018133joelho pvc 20mm p agua 90deg 1 l; conexao para mangueira de jardim;41;40;33;7
54;17 conexao hidraulica  aplicacao caixa d agua bitolai     conexao hidraulica material pvc  cloreto de polivinila tipo adaptador com flanges e anel vedacao tipo fixacao roscavel aplicacao caixa d agua bitol; reboque especial de construcao para rocha   transportador basculante do tipo fora de estrada ;41;205;94;111
114;agua destilada galao 5 litros galao de agua destilada nao injetavel nao esteril e quimicamente pura pode ser utilizada em autoclaves ipl e aparelhos de criolipolise agua destilada para uso no processo de esterilizacao em autoclave e equipamentos de ipl; servicos para  a  infraestrutura de tecnologia da informacaoe comunicacao tic  nao classificados em outros top;41;252;111;141
204;agua sanitaria alvejantedesinfetante bactericida germicida  composicao hipoclorito de sodio hidroxido de sodio  cloreto  e agua embalagens de 1 litro val 6 meses cx c 12 und; unidades de propulsao inertes a combustivel solido de veiculos espaciais e misseis guiados e seus c;41;173;100;73
218;agua sanitaria solucao aquosa a base de hipoclorito sodio 1 litro agua sanitaria solucao aquosa a base de hipoclorito sodio ou calcio com validade de 6 meses frasco plastico opaco teor de cloro ativo 2 pp a 25 pp 1 litr; servicos para  a  infraestrutura de tecnologia da informacaoe comunicacao tic  nao classificados em outros top;41;219;111;108
229;alvejante  principio ativo hipoclorito de sodio 20 25 % pp cloro ativo composicao principio ativo  alcalinizante  estabilizante essencia e agua embalagem de 1000 ml; servicos do comercio por atacado prestado por comissao o contratode livrosrevistasperiodicos e artigos de escritori;41;164;116;48
239;aromatizante odorizador de ambiente aerosol frasco com 360 ml aroma lavanda composicao agua solvente alcalinizante antioxidantes fragrancia preservante emulsificante coadjuvante e propel; servicos do comercio por atacado prestado por comissao ou   por contratode maquinariaequipamentos e supr;41;186;105;81
247;barraca 02x02 em estrutura metalica de aco cobertura em lona anti chama com balcao modelos 01 agua 02 aguas piramide bruxa cupula a criterio do municipio     212873372801; reboque especial de construcao para rocha   transportador basculante do tipo fora de estrada ;41;170;94;76
274;biscoito salgado tipo agua e sal  biscoito salgado tipo agua e sal em perfeito estado de conservacao serao rejeitados biscoitos mal cozidos queimados nao podendo apresentar excesso de dureza e nem se apresentar quebradico embalados em p; servicos de promocao e apresentacao relacionados as artes cenicas e outros espetaculos ao v;41;236;92;144
415;caneta gel dourada ou prata tinta gel resistente a agua e luz grip triangular emborrachado fluxo de tinta suave e constante refil autolimpante permitindo que toda a tinta seja util; equipamento especializado para oficina de manutencao e reparo de material de controle de tir;41;180;93;87
439;cera liquida vermelha composicao carnauba dispersao acrilica metalizada solvente tensoativos nao ionicos coadjuvante alcalizante plastificante 12 benzoisothiazolinona 3 fragancia e agua  750 ml; servicos relacionados com a producao de filmes cinematograficos de televisao e programas de radi;41;193;97;96
445;cloreto de sodio sal granulado grosso  destinacao tratamento de agua para consumo humano  processo dissociacao eletrolitica e uso em gerador e dosador de solucao oxidante a base de hipoclorito de sodio com as seguintes propriedades cloreto de s; servicos do comercio por atacado prestado por comissao o contratode livrosrevistasperiodicos e artigos de escritori;41;244;116;128
446;cloro 02 litros de 1a qualidade acao germicida e bactericida desinfeta e desodoriza eliminando bacterias composicao de hipoclorito de sodio e aguateor de cloro ativo30% a 35% com todas informacoes pertinentes ao produto previsto no edit; servicos do comercio por atacado prestado por comissao o contratode livrosrevistasperiodicos e artigos de escritori;41;236;116;120
509;doce de pessego em calda lata de doce  pessego  em calda com as descricoes minimas lata 450 gramas  peso drenado  pessegos em metades agua acucar xarope de glicosefrutose e acidulante acido citrico nao contendo gluten ; servicos de leasing ou aluguel de televisores radios gravadores de video e equipamentos e acessorios correlat;41;218;110;108
523;essencia de eucalipto frs 140mlessencia de eucalipto frs 140ml  diluicao 100ml para 05 lts de agua na embalagem devera constar data de fabricacao e validade do produto 310338; reboque especial de construcao para rocha   transportador basculante do tipo fora de estrada ;41;174;94;80
579;giz escolar branco ? giz escolar branco caixa com 50 unidades giz para quadro negro tipo palito cor branca atoxico caracteristicas adicionais plastificado e antialergico composicao gesso e agua padrao de qualidade igual ou superior a delt; servicos do comercio por atacado prestado por comissao o contratode livrosrevistasperiodicos e artigos de escritori;41;238;116;122
590;item 11177 agua sanitaria a base de cloro com acao alvejantebactericidadesinfetante com validade minima de 06 meses armazenados em frascos plasticos de 01 litro com dados do fabricante data de fabricacao e prazo de validade uso domes; servicos do comercio por atacado prestado por comissao o contratode livrosrevistasperiodicos e artigos de escritori;41;233;116;117
671;lustra moveis espessante   embalagem 200mlpara polimento de madeira e moveis em geral  composicao  silicone  oleo mineral  preservante lavanda e agua  na embalagem devera constar informacoes e advertencias 92531; equipamento especializado para oficina de manutencao e reparo de material de controle de tir;41;211;93;118
691;macarrao cortado tipo padre nosso   com ovos enriquecido com ferro e acido folico deverao ser fabricados a partir de materias primas sas e limpas isentas de materias terrosas parasitos e larvas as massas ao serem postas na agua nao deverao turv; servicos do comercio por atacado prestado por comissao o contratode livrosrevistasperiodicos e artigos de escritori;41;244;116;128
698;maionese 500g  vidros de maionese contendo 500 gramas 0   zero por cento   de gordura trans valor energetico 40 kcal fonte de vitamina e  agua oleo vegetal ovos pasteurizados amido modificado vinagre acucar salsuco de limao acidulante ac; servicos de agenciamento de transporte de carga e outros servicos auxiliares de transport;41;237;90;147
738;pao doce tipo hot dog  pao doce tipo hot dog produto obtido por processamento tecnologico adequado da massa preparada com farinha de trigo fermento biologico agua sal gordura o pao deve ser cortado na vertical  sentido do comprimento  e emb; servicos do comercio por atacado prestado por comissao ou   por contratode maquinariaequipamentos e supr;41;240;105;135
775;reabastecedor de tinta para pincel de quadro branco tinta liquida a base de alcool corantes organicos solvente a agua tinta desenvolvida especialmente para reabastecedor marcadores de quadro branco contem 500ml cores azul preta e vermelh; servicos de engenharia durante a fase de construcao e de instalacao de obras de engenharia civil;41;237;97;140
802;requeijao cremoso pote 500gcreme de leite soro de leite caseinato de calcio agua sal cloreto de calcio fermentos lacteos enzima protease estabilizantes polifosfato de sodio e difosfato de sodio conservante sorbato de potassio nao contem gl; servicos de leasing ou aluguel de televisores radios gravadores de video e equipamentos e acessorios correlat;41;239;110;129
808;reservatorio caixa d'agua tipo tanque de 5000 litros tanque vertical polietileno 5000l   tampa de 14 de volta com travamento total   materiais da estrutura em polietileno   reservatorio tipo cisten; servicos gerais de construcao de estradasexceto elevados ruasviasestradas de ferro e pistas de aterriz;41;197;103;94
855;suco concentrado  abacaxi  pet 500ml ingr suco conc de abacaxi agua potavel aromat identico ao natural de abacaxi acid acido citrico conserv benzoato de sodio e metabissulfito de sodio estabilizantes goma gelana e citrato de sodio s gluten; servicos do comercio por atacado prestado por comissao o contratode livrosrevistasperiodicos e artigos de escritori;41;239;116;123
856;suco concentrado de maracuja 1l polpa e suco concentrado de maracuja agua potavel conservantes benzoato de sodio e metabissulfito de sodio e corante caroteno beta caroteno sintetico sem adicao de acucar nao contem gluten; componente mecanico   veiculo de controle  remotode manipulacao de carga explos;41;220;80;140
861;suco de manga concentrado liquido para refresco de fruta sabor manga rendimento minimo de 4 litros  1 parte de suco para 3 partes de agua    ingredientes agua polpa de manga suco concentrado de manga suco de maca clarificado acidulante ac; servicos de engenharia durante a fase de construcao e de instalacao de obras de engenharia civil;41;238;97;141
886;te de pvc soldavel de 20 mm pn 750 kpa para sistemas prediais agua fria caracteristicas tecnicas e fabricacao de acordo com abnt nbr 5648 de 2010 e abnt nbr 5626 de 1998 ; equipamento especializado para oficina de manutencao e reparo de material de controle de tir;41;170;93;77
903;termometro digital com ponta flexivel totalmente resistente a agua com bateria de longa duracao tempo minimo aproximado de medicao 1 minuto faixa de medicaouso 32oc a 42oc com estojo de protecao contendo data de fabricacao e no de lot; servicos para  a  infraestrutura de tecnologia da informacaoe comunicacao tic  nao classificados em outros top;41;234;111;123
4;sabao em po  cor azul composto por tensoativo anionico alcalinizante sequestrante branqueador optico enzimas perfume e agua com tensoativo biodegradavel acondicionado em caixa ou saco plastico resistente contendo 1 kg 15256; servicos para  a  infraestrutura de tecnologia da informacaoe comunicacao tic  nao classificados em outros top;40;223;111;112
56;280joelho 90 graus pvc soldavel dn 32mm instalado em ramal ou subramal de agua joelho 90 graus pvc soldavel dn 32mm instalado em ramal ou subramal de agua  fornecimento e instalacao af_122014; servicos de engenharia durante a fase de construcao e de instalacao de obras de engenharia civil;40;191;97;94
219;agua sanitaria a base de hipoclorito de sodio com teor de cloro ativo entre 20 a 25 % pp embalagem plastica de 01 litro com dados de identificacao do produto marca do fabricante data de fabricacao prazo de validade cx com no minimo 12 und globo ou superi; servicos do comercio por atacado prestado por comissao ou   por contratode maquinariaequipamentos e supr;40;254;105;149
225;algodao ortopedico 15 cm algodao ortopedico 15 cm elaborada a partir de fibras 100  de algodao cru hidrofobo nao absorve agua em forma de manta com camada de goma em uma das faces enrolamento uniforme em toda sua extensa; servicos do comercio por atacado prestado por comissao ou   por contratode produtos farmaceuticos e med;40;220;104;116
241;avental  avental de protecao para o corpo do usuario contra provenientes riscos de produtos quimicos  acidos  alcalis e detergentes  e agua  em pvc reforcado em trevira sem emenda costuras laterais reforcadas nas dobras do tecido com apr; servicos para  a  infraestrutura de tecnologia da informacaoe comunicacao tic  nao classificados em outros top;40;237;111;126
253;bebedouro de agua tipo pressao 02 saidas sendo uma de jato e outra para copo termostato blindado gabinete pia e reservatorio de agua em aco inoxidavel serpentina de cobre externa e isolamento termico de isopor dimensoes aproximadas 96cm alt; reboque especial de construcao para rocha   transportador basculante do tipo fora de estrada ;40;240;94;146
271;biscoito agua e sal  biscoito tipo cream cracker crocante inteiro ingredientes  basicos farinha de trigo gordura vegetal hidrogenada agua e sal rotulo com informacao nutricional validade lote embalagem de 400g; maquinas especializadas para fabricacao  de  semicondutorescircuitos microeletronicos e placas de c;40;209;100;109
337;bomba submersa para captacao de agua potavel em pocos profundos tubulares com potencia 5 cv voltagem 220 v rpm 3460 frequencia 60 hz monofasico classe y fs 12 corrente 31 4 a corrente ifs 323 a reg continuo temperatura maxima agua 40o c; servicos de promocao e apresentacao relacionados as artes cenicas e outros espetaculos ao v;40;236;92;144
338;bomba torneira para garrafao galao de agua 10 e 20 litros funcionamento simples de encaixe na boca do galao de agua de 10 ou 20 litros sem ter a necessidade de viralo o acionamento da bomba e feito a partir de um botao acionador na parte superi; servicos de agenciamento de transporte de carga e outros servicos auxiliares de transport;40;244;90;154
405;cal hidratada para tratamento de agua  ca oh 2  9000%  minimo mg oh 2  22% maximo caco3  50% maximo granulometria maxima 22% retido em peneira de 0149 mm; equipamento de orientacao  radiogoniometria  de aeronav;40;153;56;97
410;caminhao iveco tector 9190 placa qxk9e85 ano 20192020 chassi 93za085dzl8937082radiador de agu; maquina de resistencia eletrica para solda com acumulador de energ;40;93;67;26
437;cera liquida incolor 750 ml 1a qualidade  composicao dispersao acrilica metalizada acrilmax emulsao de polietileno agente formador de fio agente nivelador plastificante fragancia concervante corante exeto ardosia max incolor e agu; servicos do comercio por atacado prestado por comissao ou   por contratode produtos farmaceuticos e med;40;230;104;126
462;contratacao de empresa especilalizada  em servico de  desalojamento de pomboscom aplicacao de gel repelente com garantia de 30 dias incluindodesintetizacao e desratizacao com monitoramento e limpeza nas caixas d agua  pre escolar gaspar braz de arauj; maquinas especializadas para fabricacao  de  semicondutorescircuitos microeletronicos e placas de c;40;250;100;150
508;dispenser redondo em aco inox para copo de agua 180200ml  dimensoes do produto 43cm altura x 75cm diametro  o produto possui garras na base para ajuste da saida do copo e duas pequenas abas para fixacao na pared; servicos do comercio por atacado prestado por comissao o contratode livrosrevistasperiodicos e artigos de escritori;40;211;116;95
511;ebulidor aluminio pequeno 127v 1000w * 1000w | 127v * 24 cm * material metal * ferve agua super rapido * indicado para cafe cozinhar ovos batatas e legum; servicos do comercio por atacado prestado por comissao ou   por contrato de frutas e legum;40;153;91;62
522;esponja para limpeza em manta nao tecida fibras sinteticas unidas com resina a prova de agua e impregnada 100 em todo o volume com mineral abrasivo indicada para superficies delicadas pecas sanitarias superficies em inox pecas em porcel; servicos para  a  infraestrutura de tecnologia da informacaoe comunicacao tic  nao classificados em outros top;40;236;111;125
580;glucagon po liofilizado e diluente p solucao glucagon po liofilizado e diluente para solucao injetavel contem cloridrato de glucagon biossintetico equivalente a 1 mg ou 1 ui de glucagon frascoampola e diluente agua para injeca; unidades de propulsao inertes a combustivel solido de veiculos espaciais e misseis guiados e seus c;40;226;100;126
711;marcador de texto cor amarela fluorescente ponta chanfrada com 2 possibilidades de largura dos tracos tracos largos e finos tinta a base de agua espessura do traco fino10 mm e do traco largo 45 mm ponta em polietileno corpo tampa e fundo em polipropilen; servicos do comercio por atacado prestado por comissao o contratode livrosrevistasperiodicos e artigos de escritori;40;253;116;137
723;mop giratorio kit contendo 1 balde com capacidade de no minimo 12 litros com alca sexto e moldura com funcao rotatoria de 360o para facilitar a remocao do excesso de agua e lavagem do refil um cabo telescopico com base e contendo 5 refis em microfibra ; servicos do comercio por atacado prestado por comissao o contratode livrosrevistasperiodicos e artigos de escritori;40;252;116;136
751;pincel para pintura  redondo  no 08  composicao ponei cor marrom  filamento ponei  formato redondo  ideal para contornos  filetes  manchas  indicacao tinta a base de agua  tecnica aquarela  guache  virola alumini; servicos do comercio por atacado prestado por comissao o contratode livrosrevistasperiodicos e artigos de escritori;40;212;116;96
758;polimeros floculante secundario anionico de alto peso molecular  composicao polimeros organicos naturais carater ionico anionico aspecto po branco ph solucao 01  100   05 solubilidade em agua 01  05    ; servicos do comercio por atacado prestado por comissao o contratode livrosrevistasperiodicos e artigos de escritori;40;202;116;86
773;purificador de agua refrigerado purificador de agua refrigerado capacidade 4 litros na cor branco dimensoes 52x34x43 cm voltagem 110 volts  contendo 02 torneiras fabricadas em polipropileno atoxicas e resistentes sendo 01 para agua gelada e ; servicos do comercio por atacado prestado por comissao o contratode livrosrevistasperiodicos e artigos de escritori;40;241;116;125
776;reagente para determinacao de nitrogenio nitrato pelo metodo dimethylphenol metodo hach 10206 faixa de analise 535mgl no3n   aprovado usepa para analise de agua potavel  reagente padronizado predosado e pronto para uso  embalado em tubos de ens; servicos do comercio por atacado prestado por comissao ou   por contratode produtos farmaceuticos e med;40;244;104;140
780;refletores 200w led refletores 200w led 100  nacional osram ip66resistente a agua voltagem bivolt automatico temperatura de cor branco frio para campo e quadra de futebol com alca muda; reboque especial de construcao para rocha   transportador basculante do tipo fora de estrada ;40;184;94;90
782;refrigerante 02 litros noz de cola refrigerante 02 litros original de 1a qualidade agua gaseificada acucar extrato de noz de cola refrigerante de 02 litros original de cafeina corante caramelo iv acidulante ins338  e aroma nat; acionador interno do alternador  estator  de corrente eletrica  veiculo automo;40;226;79;147
858;suco de caixa manga produto obtido a partir de agua acucar  suco concentrado de fruta aroma natural acidulante acido citrico e conservador dioxido de enxofre prazo da validade na embalagem cada embalagem contendo 1 litro sabor mang; equipamento especializado para oficina de manutencao e reparo de material de controle de tir;40;231;93;138
917;tinta esmalte premium a base de agua primeira linha para madeira e metal cores variadas aplicacao interior e exterior sem cheiro rendimento medio entre 50 e 80m  por galao fornecido em galao de 36 litros com validade minima de 12 meses  ; maquinas especializadas para fabricacao  de  semicondutorescircuitos microeletronicos e placas de c;40;237;100;137
953;tubo de pvc soldavel de 20 mm com 6m e pn 750 kpa para sistemas prediais agua fria     caracteristicas tecnicas e fabricacao de acordo com abnt nbr 5648 de 2010 e abnt nbr 5626 de 1998; reboque especial de construcao para rocha   transportador basculante do tipo fora de estrada ;40;184;94;90
64;72 conexao hidraulica material pvc tipo te soldavel bitola lado soldavel 20  conexao hidraulica material pvc  cloreto de polivinila tipo te tipo fixacao soldavel bitola lado soldavel 20 aplicacao instalacoes prediais agua fria normas tecn; equipamento especializado para manutencao reparo e inspecaode minas submarinas e bombas de profund;39;238;99;139
86;adesivo p esmalte e dentina fotopolimerizavel adesivo para esmalte e dentina fotopolimerizavel solvente de agua e alcool monocomponente que permita o uso como primer e adesivo simultaneamente e que apresente em sua composicao alcool etilico bisf; servicos de instalacao da maquinaria e dos equipamentos medicos profissionaise instrumentos de precisao e o;39;245;108;137
89;adocante dietetico liquido adocante dietetico liquido agua edulcorantes artificiais sucralose e acesulfamek espessante carboxi metil celulose conservante benzoato de sodio e acidulante acido citrico frasco plastico com bico dosador de 50 a100ml; servicos do comercio por atacado prestado por comissao o contratode livrosrevistasperiodicos e artigos de escritori;39;244;116;128
251;bebedouro de agua de colunacom reservatorio de 25 litros de aguaem polipropileno isolamento em eps revestimento externo em inox 430 base injetada aparador com dreno em inox 430 serpentina interna em aco inox 304 02 torneiras gas ecologico62045; servicos de instalacao da maquinaria e dos equipamentos medicos profissionaise instrumentos de precisao e o;39;243;108;135
265;bebida de soja varios sabores embalagem tetra pack ou tetra brick asseptic com 1 litro ingredientes extrato de soja agua acucar sal oleo vegetal de soja aromatizantes estabilizantes vitaminas e emulsificantes nao deve conter gluten e lact; servicos para  a  infraestrutura de tecnologia da informacaoe comunicacao tic  nao classificados em outros top;39;238;111;127
301;bolo sabor natural  bolo sabor natural com peso aproximado de 500g a 600g contendo os ingredientes farinha de trigo enriquecida com ferro e acido folico margarina fermento acucar agua ou leite ovos o produto dever estar acondicionado em ; servicos para  a  infraestrutura de tecnologia da informacaoe comunicacao tic  nao classificados em outros top;39;237;111;126
417;caneta hidrografica  estojo com 12 cores a base de agua medindo aproximadamente 14cm ponta 40mm escrita 18mm tinta a base de agua nao recarregavel atoxico validade de no minimo 02 anos contados a partir da data de entrega tampa apr; equipamento especializado para oficina de manutencao e reparo de material de controle de tir;39;231;93;138
467;copo descartavel 300 ml resistente  copo plastico de boa qualidade branco ou transparente em polipropilenonao toxicocapacidade de 300 ml para agua suco e refrigerante com resistencia diferenciada do copo de 300 ml comumo pacote deve conter 1; equipamento especializado para oficina de manutencao e reparo de material de controle de tir;39;241;93;148
784;refrigerante a base de cola 2 litros  refrigerante em garrafa descartavel de 2000ml sabor cola  agua gaseificada  extrato de noz de cola cafeina corante amarelo iv acidulante ins 338 e aroma natural nao contem gluten nao alcool; unidades de propulsao inertes a combustivel solido de veiculos espaciais e misseis guiados e seus c;39;227;100;127
792;refrigerante sabor guarana 2 lt fd c 06 unid comp agua gazeificada extrato vegetal de guarana aroma natural conservador ins 211acidulante 330 corante ins 150d edulcorantes artificiais ascarina sodica 160mg e ciclamata de sodio 697mg gel; servicos do comercio por atacado prestado por comissao o contratode livrosrevistasperiodicos e artigos de escritori;39;236;116;120
839;servtranspescdiurnorota 1veic12lugmot veiculo de 12 lugares incluindo motorista  rota 1  diurno   saida distrito merces de agua limpa povoado capao das flores fazenda da floresta alto do donato fazenda da prata fazenda do marden faz; servicos gerais de construcao de estradasexceto elevados ruasviasestradas de ferro e pistas de aterriz;39;232;103;129
915;tinta dimensional nao toxica soluvel em agua tinta dimensional nao toxica soluvel em agua secagem rapida pronta para uso cores misciveis entre si composicao resina de pva agua aditivos carga inerte e pigmentos pote com trinta e sete mililitros  125 fl oz; servicos de instalacao da maquinaria e dos equipamentos medicos profissionaise instrumentos de precisao e o;39;254;108;146
934;tinta para tecido lilas  tinta para tecido lilas tinta para tecido fosca 37ml a base de resina acrilica soluvel em agua ideal para aplicacao a pincel esponja ou carimbo em tecidos de algodao sem goma nao sinteticos e resistente a lavagens cores misciveis entre si nao tox; servicos para  a  infraestrutura de tecnologia da informacaoe comunicacao tic  nao classificados em outros top;39;271;111;160
947;tubo de polietileno de 1 12  ponta azul tubo de polietileno de 1 12   ponta azul diametro externo minimo de 518mm diametro interno de 39mm espessura minima da parede de 64mm utilizado para passagem de agua rolo de 100 metr; componente de todo tipo de motor de resfriamento exceto motor primario de missil gui;39;222;85;137
971;umidificador para oxigenoterapia umidificador para oxigenoterapia e composto por uma tampa de nylon verde um tubo que permite a passagem de particulas de agua e um reservatorio plastico o copo umidificador possui marcacao de nivel maximo e min; servicos do comercio por atacado prestado por comissao o contratode livrosrevistasperiodicos e artigos de escritori;39;243;116;127
234;anestesico local injetavel contendo 50 anestubes de cristal de 18ml caracteristicas cloridrato de lidocaina 200mg epinefrina base 100  g veiculo aquoso qsp bissulfito de sodio cloreto de sodio e agua lidocaina hcl 2%  epinefrina 1100000 36mg 18 g; servicos do comercio por atacado prestado por comissao o contratode livrosrevistasperiodicos e artigos de escritori;38;246;116;130
249;bebedouro coluna garrafo especificacoes minimas frequencia 60 hz potencia 112 w controle xterno de temperatura termostato frontal bandeja de agua removivel medindo 99 c x 31 3 cm pesando em media 14 8 kg 170251; reboque especial de construcao para rocha   transportador basculante do tipo fora de estrada ;38;210;94;116
285;bloqueador solar fps 30  frasco 200 ml  agua acetato de vitamina e alcool estearilico benzonato de alquila c12 15 bisetilexiloxifenol metoxifenil triazina butilcabormato de iodopropinila butileno glicol carbomero potassio fosfato de setil; servicos para  a  infraestrutura de tecnologia da informacaoe comunicacao tic  nao classificados em outros top;38;238;111;127
342;brilho aluminio composicao acido dodecil benzeno sulfonico espessante coadjuvante fragrancia preservante corante e agua componente ativo acido dodecil bezeno acido sulfonico ph a 1%pp 25 c 20 a 30 aspecto fisico liquido odor caracteristico embalagem com 500 ml; servicos do comercio por atacado prestado por comissao ou   por contratode produtos farmaceuticos e med;38;260;104;156
345;cafeteira para cafe expresso e cappuccino com reservatorio de aproximadamente 2 litros de agua com vaporizador com capacidade de 2 xicaras de cada vez utilizacao de po de cafe moido ou sache potencia de 800w dimensoes aproximadas do produto  cm axlxp 30x25x27cm; servicos para  a  infraestrutura de tecnologia da informacaoe comunicacao tic  nao classificados em outros top;38;261;111;150
414;caneta esferografica escrita media cor azul  caneta esferografica  escrita media tinta a base de agua  corpo plastico medindo com tampa aproximadamente 14cm  composicao carga atoxica na cor azul  tampa na mesma cor da tinta e com respiro antiasfixiante  gravada no corpo a marca do fabric; servicos para  a  infraestrutura de tecnologia da informacaoe comunicacao tic  nao classificados em outros top;38;288;111;177
429;carbocisteina xarope adulto 50mgml cada ml do xarope adulto contem carbocisteina  50 mg veiculo q s p  1 ml veiculo sacarose  alcool etilico  corante caramelo  essencia artificial de canela  essencia artificial de rum  hidroxido de sodio  metilparabeno e agua purific; servicos do comercio por atacado prestado por comissao o contratode livrosrevistasperiodicos e artigos de escritori;38;267;116;151
461;container de lixo com capacidade de 1000 litros nominimo fabricado em polietileno de alta densidade com protecao contra raios uv possui 04 rodas de borracha macica tampa que evita o acumulo de agua e antirruido carga de 400 kg no minimo projetado para ser utilizado na coleta mecan; servicos do comercio por atacado prestado por comissao ou   por contratode produtos farmaceuticos e med;38;281;104;177
464;copo alto tipo long drink  material vidro  cilindrico  sem curvaturatransparente  incolor  liso  reutilizavel  para agua  suco  refrigerante  capacidade 300ml  dimenses de altura 13cm  6 5 de dimetro  variacao de 15 108921; controle giroscopico  direcional  para  superficieacionado por sistema hidraulico para aeronav;38;222;95;127
479;corretivo liquido  corretivo liquido frasco de 18ml a  base  de  agua  ideal  para  uso sobre   todos   os   papeis   para corrigir fotocopia fax e tinta de caneta    esferografica    produto atoxico    teste     do     produto excelente cob; servicos do comercio por atacado prestado por comissao o contratode livrosrevistasperiodicos e artigos de escritori;38;241;116;125
521;esponja para limpeza dupla face em nylon e manta nao tecida fibras sinteticas unidas com resina a prova de agua e impregnada 100 em todo o volume composta com mineral com textura similar a talco dimensoes 75 x 110 mm variacao aceitavel 10; servicos de engenharia durante a fase de construcao e de instalacao de obras de engenharia civil;38;238;97;141
631;lavadora de roupas 16 kg com dispenser autolimpante e ciclo silencioso altura 1020 cm clean jato dagua cesto inox consumo de agua 180lciclo consumo de energia 049 kwhciclo dimensoes produto embalado axlxp 1055 x 700 x 770 cm peso bru28538; servicos gerais de construcao de tubulacoeslinhas de comunicacao e de energia de longa distanc;38;238;95;143
634;limpa aluminio remove sujeira e manchas devolve brilho e acabamento original depois de polimento nao mancha e nao ataca o aluminio e suas ligas elimina oleosidade e residuos acumulados concentrado base de agua ecologico biodegradavel neutro  nao agride a pel; reboque especial de construcao para rocha   transportador basculante do tipo fora de estrada ;38;258;94;164
686;luva simples pvc soldavel eb892 pagua fria de 60mm  luva simples  marrom para agua fria de 60mm com capacidade de suporte de 75mca de pressao estatica cor marrom marcas tigre amanco unocann ou similar eb892nbr56485680 4898; servicos para  a  infraestrutura de tecnologia da informacaoe comunicacao tic  nao classificados em outros top;38;222;111;111
741;papel foto acabamento alto brilho  definicao profissional alto resistente a agua secagem instantanea compatibilidade de tinta dye & pigment  condicoes de  exibicao em album e porta retrato aplicacao em impressoes e ampliacoes profissionais com 50 folh; unidades de propulsao inertes a combustivel solido de veiculos espaciais e misseis guiados e seus c;38;251;100;151
754;pirulito de esponja pirulito de esponjamaterial utilizado para realizar a avaliacao da resposta sensorial intraoral sabor limao e um ?cotonete? descartavel com espuma na ponta material livre de latex com alta capacidade de absorcao de agua haste dobrase facilmente sem quebrar atingindo lugares dificel; equipamentos para contramedidas eletronicas  contracontramedidas e de capacidade de reacao rap;38;302;95;207
781;refrigerante 02 litros  a base de cola refrigerante  a base de cola  em embalagem com 2l agua gaseificada  acucar  extrato de noz de cola  cafeina  corante caramelo iv  acidulante ins 338 e aroma natural  validade nao inferior a 4 meses  a contar da data de entreg; servicos gerais de construcao de estradasexceto elevados ruasviasestradas de ferro e pistas de aterriz;38;264;103;161
783;refrigerante 1a linha a base de cola bebida nao alcoolica nao fermentada e gaseificada composto por agua mineral gaseificada acucar suco natural concentrado de cola aroma natural de cola embalagem plastica de 2 litros com data de fabricacao e validade minimo 6 meses impressas na embal; servicos do comercio por atacado prestado por comissao o contratode livrosrevistasperiodicos e artigos de escritori;38;285;116;169
848;servico de locacao e montagem  de tendas 3 x 3 piramidal sanfonada nas dimensoes 3x3 m com altura minima de 250 m cobertura em poliester reta com saidas de ar sistema de escoamento de agua nas laterais estrutura e pes em aluminio eou aco carbono cor branca necessaria a art duracao 3 dias de event; servicos do comercio por atacado prestado por comissao o contratode livrosrevistasperiodicos e artigos de escritori;38;297;116;181
884;tanquinho lavadora de roupa plastico semiautomatica capacidade de 10kg de roupa molhada tensao  voltagem 110v220v com baixo consumo de energia 2 dispensers um para sabao e outro para amaciante filtro catafiapos 3 niveis de agua garantia minima de 12 mes; servicos do comercio por atacado prestado por comissao ou   por contratode produtos farmaceuticos e med;38;253;104;149
937;tinta pva para artesanato 250ml verde vivo a base de latex pva de secagem rapida acabamento fosco soluvel em agua e nao toxica dimensoes do produto ?205 x 7 x 95 cm  295 g volume 250 ml cor verde v; instrumento eletrico painel de verificacao ensaioe medicao de aparelho eletrico  eletron;38;197;89;108
88;adocante dietetico liquido  100% stevia ingredientes agua edulcorantes naturais glicosideos de steviol conservantes benzoato de sodio e sorbato de potassio acidulante acido citrico sem aspartame sem ciclamato sem sacarina sem acesulfamek unidades de 80ml prazo de validade minimo 2 anos a contar a partirda data de entreg; servicos de leasing ou aluguel de televisores radios gravadores de video e equipamentos e acessorios correlat;37;321;110;211
512;elemento filtrante retencao de particulas p  iii > 5 a < 15 um reducao de cloro livre ci > 75% vida util 4000 litros ou 06 meses parametros que poderao variar de acordo com a qualidade da agua e a frequencia de uso dimensoes altura 225 cm  largura 105 cm  profundidade 105 cm; servicos de manufaturar executados em metais em produtos de metalmaquinaria e equipamentospossuida por outr;37;275;108;167
571;galeria celular de concreto armado  secao quadrada  para galeria de agua pluvias  capacidade de resistencia 60 toneladas  conforme normas 88902003  medindo largura x altura 300 x 300 metros h = 800 metros  espessura de parede 2200cm  comprimento das pecas 100 metr; servicos de instalacao da maquinaria e dos equipamentos medicos profissionaise instrumentos de precisao e o;37;264;108;156
637;limpador multiuso composto de alquil benzeno sulfonato de sodio coadjuvante sequestrante alcool etoxilado fragancia e agua rotulo contendo data de fabricacao data de validade numero de lote identificacao do fabricante e numero do registro na anvisa ou outro orgao competente frasco de 500ml; servicos para  a  infraestrutura de tecnologia da informacaoe comunicacao tic  nao classificados em outros top;37;290;111;179
697;macarrao tipo parafuso primeira qualidade com ovos  pacote de 500g pacotes bem fechados e intactos composicao minima carboidratos 70g proteinas 13g lipidios 12g colesterol minimo 15mg as massas ao serem postas na agua nao deverao turvalas antes da coccao nao podendo estar fermentadas ou ranc; servicos do comercio por atacado prestado por comissao o contratode livrosrevistasperiodicos e artigos de escritori;37;292;116;176
708;marca texto amarelo   caneta fluorescente tinta a base de agua contendo 250g espessura do traco 25 ou 500 mm longevidade aproximado 2500 cm2corpo tampa e fundo em polipropileno filtro em poliester ponta chanfrada em polietileno cores vivas secagem rapida e tinta livr; servicos do comercio por atacado prestado por comissao o contratode livrosrevistasperiodicos e artigos de escritori;37;267;116;151
713;margarina 500 g  composicao basica com oleos vegetais liquidos e interesterificados  agua  reconstituido  sal diglicerideos de acidos graxos e lecitina de soja  ulante acido citrico  antioxidante  aroma identico ao natural de manteiga  nao contem gluten  embalagem com 500g similar a qualy; servicos de engenharia durante a fase de construcao e de instalacao de obras de engenharia civil;37;289;97;192
765;protetor solar fps 60 enriquecido com vitamina e nao contem paba  oil free  indicado para pessoas de pele extremamente sensivel que sempre se queimam e nunca escurecem resistente a agua protecao contra a acao dos raios uva e uvb fpuva 20 dermatologicamente testado semelhante ou superior a marca prosun; servicos do comercio por atacado prestado por comissao ou   por contratode maquinariaequipamentos e supr;37;302;105;197
862;suco de maracuja concentrado de maracuja  contendo agua  suco de maracuja integral  suco de maracuja concentrado  conservantes metabissulfito e benzoato de sodio  acidulante acido citrico  estabilizante pectina e goma xantana  corante natural carmim de cochonilha  embalagem de 500ml; equipamentos para contramedidas eletronicas  contracontramedidas e de capacidade de reacao rap;37;283;95;188
864;suco em caixinha de 200 ml com canudo ingredientes agua suco concentrado de pessego acucar aroma natural acidulante acido citrico e espessante goma xantana nao contem gluten qualidade similar a marca dell valle validade minima de 6 meses a partir da data de entreg; equipamentos para contramedidas eletronicas  contracontramedidas e de capacidade de reacao rap;37;264;95;169
868;sulfadiazina de prata 10mgg creme dermatologico cada grama do creme dermatologico contem sulfadiazina de prata 10 mg veiculo qsp 1 g alcool cetoestearilico cetomacrogol 1000 petrolato liquido petrolato amarelo alcool de lanolina propilenoglicol metilparabeno propilparabeno edetato dissodico butilidroxitolueno e agua purific; servicos do comercio por atacado prestado por comissao o contratode livrosrevistasperiodicos e artigos de escritori;37;325;116;209
217;agua sanitaria liquido alvejante desinfetante e uso geral liquido transparente composto de hipoclorito de sodio hidroxido de sodio carbonato de sodio e agua com teor de cloro ativo 2  a 25  pesopeso com autorizacao de funcionamento do fabricante concedido pela anvisa frascos de 1 litro com lacre de rosquear caixa com 12 un; servicos de leasing ou aluguel de televisores radios gravadores de video e equipamentos e acessorios correlat;36;324;110;214
223;alcool gel gel a base de alcool para higienizacao  a 70  com acao antisseptica  sem enxague  composicao alcool etilico  polimero carboxilico  neutralizante  umectante  conservante  quelante e agua deionizada  prazo de validade 24 meses a partir da data de fabricacao  embalagem 1 litr; equipamentos para contramedidas eletronicas  contracontramedidas e de capacidade de reacao rap;36;284;95;189
242;azeitonas verdes sem caroco em conserva int azeitonas verdes sem caroco em conserva inteiras com tamanhos e formas regulares conservadas em agua e sal livre de fermentacao acondicionado em embalagem integra atoxica resistente vedada hermeticamente e limpa contendo embalagem 500 gramas validade minima de 6 mes; servicos de intermediacao financeiraexceto servico bancariode investimentoservicos de seguros e de penso;36;310;105;205
419;caneta marca texto  fluorescente  ponta chanfrada  com 2 possibilidades de largura dos tracos traco caneta marca texto  fluorescente  ponta chanfrada  com 2 possibilidades de largura dos tracos tracos largos e finos  tinta a base de agua espessura do traco fino de 1 0mm e traco largo de 4 5mm ponta em polietileno  corpo  tampa e fundo em polipropilen; servicos do comercio por atacado prestado por comissao o contratode livrosrevistasperiodicos e artigos de escritori;36;352;116;236
420;caneta marca texto amarela com tinta a base de agua ponta sintetica chanfrada traco 135 mm na cor amarela fluorescente com secagem rapida  caneta marca texto amarela com tinta a base de agua ponta sintetica chanfrada traco 135 mm na cor amarela fluorescente com secagem rapida 870014386; reboque especial de construcao para rocha   transportador basculante do tipo fora de estrada ;36;286;94;192
472;copo plastico descartavel copo plastico descartavel de 200ml para agua caixa 2500 unidades os copos devem estar em conformidade com a norma tecnica 148652002 da abnt e norma nbr 13230 com massa minima de 220 gramas o vencedor devera apresentar laudo de laboratorio credenciado junto ao inmetro que comprovem os cristerios  de aceitacao estabelec; servicos para  a  infraestrutura de tecnologia da informacaoe comunicacao tic  nao classificados em outros top;36;345;111;234
501;destilador de agua portatil   especificacoes tecnicas dimensao da embalagem 450 x 290 x 450 mm peso com embalagem 500 kg garantia 12 meses frequencia 50hz60hz producao 10001200ml  1 hora capacidade maxima 04 litros voltagem 220v potencia 750w; servicos de  arrendamento  mercantil operacional ou locacaode maquinas e equipamentos sem oper;36;242;95;147
518;escorredor de macarrao em aluminio reforcado linha hotel com espessura minima de 10 mm diametro de 60 cm com furos na base e laterais para escorrer a agua base com anel de apoio com alcas escorredor de macarrao em aluminio reforcado linha hotel com espesmin10 diam60cmmm 320197; instrumentos para medicao de fluxo de liquido e  gas  nivelde liquidos e de movimentos mecan;36;277;93;184
627;kit 12   estudantes ensino infantil  com sindrome de irlen contendo caderno registro  apontador  caixa de lapis de cor jumbo  cola  tesoura  caderno desenho a3  caixa de gizao de cera com 12 cores  soroban  regua de assinatura reglete  folhas de papel braile  puncao para escrita braile   garrafa para agua   porta lapil; servicos do comercio por atacado prestado por comissao o contratode livrosrevistasperiodicos e artigos de escritori;36;320;116;204
692;macarrao espaguete no 08   massa de semola tipo espaguete comprido fino enriquecida com ferro a acido folico em embalagens de polietileno de 1 kg as massas ao serem postas na agua nao poderao turvalas antes da coccao nao podendo estar fermentadas ou rancosas prazo minimo de validade 03  tres  meses ; servicos do comercio por atacado prestado por comissao ou   por contratode produtos farmaceuticos e med;36;300;104;196
742;papel foto acabamento alto brilho definicao profissional papel foto acabamento alto brilho definicao profissional alto resistente a agua secagem instantanea compatibilidade de tinta dye & pigment condicoes de exibicao em album e porta retrato aplicacao em impressoes e ampliacoes profissionais com 50 folh; instrumento eletronico painel de verificacao  ensaio e medicao de aparelho eletrico  eletron;36;305;93;212
745;peito de frango com osso  congelado com adicao de agua no maximo de 6% levemente temperada aspecto proprio nao amolecida e nem pegajosa cor propria sem manchas esverdeada cheiro e sabor proprio com ausencia de sujidade e larvas prazo de validade condicoes de armazenamento e conservacao com temperatura idealembalagem fechada validade minima 04 quatro mes; servicos do comercio por atacado prestado por comissao o contratode livrosrevistasperiodicos e artigos de escritori;36;355;116;239
761;porta metalica 70 x 210 cm reforcada porta metalica 70 x 210 cm reforcada altura 217 cm largura do batente 6 cm pintura primer a base d?agua que e curada a 150 o garantindo cobertura uniforme e maior durabilidade ou com pintura de acabamento eletrostatica a po na cor branca e com vidr; servicos do comercio por atacado prestado por comissao ou   por contratode maquinariaequipamentos e supr;36;285;105;180
789;refrigerante de laranja 2 litros  refrigerante em garrafa descartavel de 2000ml sabor laranja  agua gaseificada  acucar suco natural de laranja 10% aromaartificial acidulante ins 330 conservador ins 211 estabilizantes ins 444 e ins480 corante artificial ins 110 nao contem gluten nao alcool; servicos para  a  infraestrutura de tecnologia da informacaoe comunicacao tic  nao classificados em outros top;36;290;111;179
827;sabonetecomposicao sais sodicos de acido graxos hidroxido de sodio glicerina cloreto de sodio formaldeido  dislirilbifenil dissulfonato dissodico edetado tetrassodico etidronato tetrassodico proteina de trigo gidrolisada fragrancia agua e corantes ci uso externo dermatologicamente testado peso liquido 125g; servicos do comercio por atacado prestado por comissao o contratode livrosrevistasperiodicos e artigos de escritori;36;307;116;191
828;saco para mudas 18x24cm sacos para muda em polietileno de baixa densidade com furos para a drenagem da agua com sanfonas laterais e solda no fundo  os saquinhos garantem uma germinacao perfeitas das sementes e plantas mais fortes e vigorosas  produto muito resistente pratico e pronto pra ser usado  material plastico preto proprio para muda  cor pret; servicos do comercio por atacado prestado por comissao o contratode livrosrevistasperiodicos e artigos de escritori;36;351;116;235
883;tanquinho de lavar roupa referencia lx1001br cor branco  modelo lavamax  semiautomatica lavaenxagua  capacidade de roupa seca 10kg  eficiencia energetica classe a  painel de controle mecanico  tipo de agua fria  tipo de abertura superior  dispenser 01sabao  01 amaciante  potencia 415 watt; servicos de instalacao da maquinaria e dos equipamentos medicos profissionaise instrumentos de precisao e o;36;289;108;181
914;tinta de sinalizacao horizontal a base de resina acrilica otima resistencia a abrasao impermeabilidade a oleos minerais oleo diesel lubrificante gasolina e agua boa cobertura facilidade de aplicacao e secagem rapida otima aderencia em varios tipos de pavimentos obedecer a norma nbr 11862 rendimento estimado 16 m21 padrao der baldes 18 litros cor vermelh; servicos de leasing ou aluguel de televisores radios gravadores de video e equipamentos e acessorios correlat;36;355;110;245
51;144 conexao hidraulica material pvc  cloreto de polivinila tipo luva tipo fixacao soldavel e roscavel bitola lado roscavel 1 bitola lado soldave  conexao hidraulica material pvc  cloreto de polivinila tipo luva tipo fixacao soldavel e roscavel bitola lado roscavel 1 bitola lado soldavel 32 aplicacao instalacoes prediais agua fr; servicos para  a  infraestrutura de tecnologia da informacaoe comunicacao tic  nao classificados em outros top;35;329;111;218
141;agua mineral 15 litros natural sem gas de primeira qualidade acondicionada em garrafa pet tampa com rosa e lacre data de validade de no minimo 06  seis meses a partir do seu envasamento a rotulagem deve conter ainda marca classificacao fonte de procedencia prazo de validade data de envase caracteristicas fisico quimica e demais informacoes exigida na legislacao em vig; servicos do comercio por atacado prestado por comissao o contratode livrosrevistasperiodicos e artigos de escritori;35;370;116;254
339;bota cano curto ndeg40 parfeita em eva material emborrachado e confortavelleveapropriado para quem trabalha  muito tempo em petotalmente vedada compativel para quem trabalha em contato com a aguacalcado fechadode acordo com a nr32solado antiderrapanteprotecao dos pes do usuario contra riscos de natureza levepossuir ca na botacor branc; servicos para  a  infraestrutura de tecnologia da informacaoe comunicacao tic  nao classificados em outros top;35;336;111;225
412;camisola hospitalar  para paciente adulto em cretone liso 100% algodao minimode 180 fios gramatura minima de 170 grm2 confeccao e apresentacao de 1  qualidade tamanho p com logomarca na frente resistente a multiplas lavagens solidez ao cloro tipo bata abertura frontal fechamento trespassado cor verde agu; equipamento especializado para oficina de manutencao e reparo de material de controle de tir;35;305;93;212
435;cera liquida  incolor   cera liquida  incolor   cera liquida auto brilho incolor para piso frio dispensando o uso de enceradeira embalagem com 850 ml dispersao acrilica metalizada alcool baririco etoxilada alcalinisante plastificante conservante fragrancia e agua parafina carnauba  selo ecologico   falcao bau; servicos do comercio por atacado prestado por comissao o contratode livrosrevistasperiodicos e artigos de escritori;35;310;116;194
440;cera liquida incolor auto brilho embalagem 850 ml acrilica com acao auto brilho indicada para pisos ceramicos granitos marmores ardosias e paviflex  composicao basica resina natural silicone agua e perfume  acondicionado em frasco plasticocontendo 850ml validade 12 meses  produto sujeito a verificacao no ato da entrega  aos procedimentos administrativos determinados pela anvis; servicos do comercio por atacado prestado por comissao o contratode livrosrevistasperiodicos e artigos de escritori;35;379;116;263
504;detergente neutro em caixas contendo 24 unidades  liquido biodegradavel concentrado bico dosador tipo pushpull frasco de 500ml composicao aquil benzeno sulfato de sodio principio ativo neutralizante conservante sequestrante coadjuvanteespessante sais organicos fragrancia corante e agua enviar amostra para analise marca pre aprovada ype e limpol; servicos do comercio por atacado prestado por comissao o contratode livrosrevistasperiodicos e artigos de escritori;35;346;116;230
513;elemento para filtro de bebedouro carbon block altura 120mm e diametro 65mm  019000994  carbon block altura 120mm e diametro 65mm vasado de ambos os lados diametro aproximado 275mm reducao de cloro livre = 75% vida util 3000 litros ou seis meses que variam de acordo com a qualidade da agua e frequencia de uso igatu ou simil; servicos do comercio por atacado prestado por comissao o contratode livrosrevistasperiodicos e artigos de escritori;35;325;116;209
628;lantejoula lantejoula  tamanho grande  pacote com 250gr nas cores verde prateada dourada azul amarela e vermelha nas cores verde capim vinho amarelo laranja vermelho vivo  verde bandeira roxo rosa pink branco preta salmao  marron  preto azul  marinho verde agua azul  royale e demais c; unidades de propulsao inertes a combustivel solido de veiculos espaciais e misseis guiados e seus c;35;285;100;185
670;lustra moveis  com teflonbrilho seco composicao oleo mineral silicone fragrancia preservante e agualiquido leitoso brancoproduto acondicionado em embalagem original lacrada com rotulo original da fabrica contendo composicaoidentificacao do produtotipo tamanholitragem dados completos e cnpj da empresa fabricante modo de uso precaucoes data de validade e constar o registro ou notificacao na anvisa ; servicos para  a  infraestrutura de tecnologia da informacaoe comunicacao tic  nao classificados em outros top;35;399;111;288
730;oleo de soja refinado embalagem de 900ml  oleo de soja refinado isento de misturas de outros oleos agua ou outras materias estranhas ao produto ausencia de sujidades larvas ou parasitas a  embalagem o produto devera estar acondicionado em embalagem primaria em garrafas tipo  pet  com volume liquido de 900 ml; servicos gerais de construcao de estradasexceto elevados ruasviasestradas de ferro e pistas de aterriz;35;309;103;206
93;adocante liquido sucralose edulcorante derivado da cana de acucar ingredientes agua edulcorantes sucralose e acesulfame de potassio conservador benzoato de sodio acidulante acido citrico e espessante carboximetilcelulose sodica embalagem plastica contendo no minimo de 25ml apresentar rotulagem de acordo com a legislacao vigente validade minima de 10 mes; servicos do comercio por atacado prestado por comissao o contratode livrosrevistasperiodicos e artigos de escritori;34;355;116;239
304;bolsa de coleta bolsa de polietileno para coleta de agua bolsa plastica com tarja de identificacao esterilizada nao fluorescente com pastilha nao toxica de tiossulfato de sodio  10mg capacidade 100ml medidas 75x185cm com sistema de fechamento  tencture troof tabs  na parte superior observacoes solicitar certificado de qualidade data de fabricacao validade e numero do lot; servicos para  a  infraestrutura de tecnologia da informacaoe comunicacao tic  nao classificados em outros top;34;373;111;262
305;bolsa de gel kit 2 bolsas termica de gel quente ou fria 13x18 cma bolsa termica de gel substitui a bolsa de agua quente tradicional com vantagens nao vaza mantem a temperatura por mais tempo que a agua e pode ser usada quente ou fria composicao produto atoxico   gel a base de celulose vegetal conteudo da embalagem 02   bolsa termica de gel quente ou fr; servicos para  a  infraestrutura de tecnologia da informacaoe comunicacao tic  nao classificados em outros top;34;354;111;243
475;corante soft gel amarelo gema 60g  ingredientes agua acucar invertido xarope de glucose amido modificado sal refinado espessantes goma carragena ins407 e goma jatai ins410 acidulante acido citrico ins330 conservadores benzoato de sodioins211 e sorbato de potassio ins202 e corante artificiais tartrazina ins102 e amarelo crepusculo ins110 nao contem gluten; servicos do comercio por atacado prestado por comissao o contratode livrosrevistasperiodicos e artigos de escritori;34;356;116;240
505;dieta enteral dieta enteral com densidade calorica aproximada de 1 2 a 1 5 calml  rica em aminoacidos de cadeia ramificada  destinado a pacientes com insuficiencia hepatica  isenta de lactose  sacarose e gluten  osmolalidade aproximadamente de 400 m osmkg agua  os produtos deverao ser entregues com prazo de vida util para 06 seis meses do tempo da validade do produt; servicos do comercio por atacado prestado por comissao ou   por contratode produtos farmaceuticos e med;34;368;104;264
588;iogurte natural zero lactose pote 170g leite reconstituido integral eou leite pasteurizado integral preparado de fruta agua amido modificado suco de maca conservador sorbato de potassio espessantes goma xantana e goma guar e acidulante acido citrico amido modificado enzima lactase fermento lacteo e espessante gelatina nao contem gluten alergicos contem leite e derivados de leit; servicos de leasing ou aluguel de televisores radios gravadores de video e equipamentos e acessorios correlat;34;380;110;270
699;maionese 500g contem agua  oleo vegetal  vinagre  amido modificado  ovoso pasteurizados  acucar  sal  suco de limao  acidulante  acido latico  espessante goma xantana  conservador acido sorbico  sequestrante edta calcio dissodico  corante paprica  aromatizante aroma natural de mostarda e antioxidantes acido citrico  bht e bha  nao contem gluten  500 gram; servicos do comercio por atacado prestado por comissao o contratode livrosrevistasperiodicos e artigos de escritori;34;356;116;240
729;nutricao completa e balanceada isotonica 300 a 350 mosmlitro de agua desenvolvida para atender nutricao completa e balanceada isotonica 300 a 350 mosmlitro de agua desenvolvida para atender as necessidades de criancas de 01 a 10 anos acrescida de vitaminas e minerais pode ser usada como nutricao oral ou enteral isenta de lactose e gluten apresentacao lata de 400 gram; servicos de leasing ou aluguel de televisores radios gravadores de video e equipamentos e acessorios correlat;34;369;110;259
785;refrigerante composto de extrato de cola 2 l  composto agua gaseificada sacarina sendo permitido vegetais cafeina corante caramelo isento de corantes artificiais livre de sujidades parasitas larvas acondicionado em garrafas  pet  com tampa de rosca contendo 02 litros devera apresentar validade minima de 03 meses a partir da data de entrega de acordo com a lei federal no 891894; servicos do comercio por atacado prestado por comissao o contratode livrosrevistasperiodicos e artigos de escritori;34;379;116;263
790;refrigerante de limao agua gaseificada acucar suco concentrado de limao aroma natural acidulante acido citrico conservadores benzoato de sodio e sorbato de potassio nao contem gluten valor energetico porcao de 200 ml 83 kl acucares 21g gorduras totais 0g gorduras saturadas 0g sodio 15mg 25% de suco pet de 02 litros referencia referencia soda sprite ou de  melhor qualidade ; servicos do comercio por atacado prestado por comissao o contratode livrosrevistasperiodicos e artigos de escritori;34;375;116;259
854;solucao reveladora pronta para uso  frasco com 475 ml frasco com exatamente 500 ml e nao 475 ml visualizacao da imagem em 30 segundos com revelador  rapido na revelacao uso simples e rapido fixar imagens em radiografias odontologicas indicado ao processamento manual de filmes dentais intraorais composicao agua dietileno glicol hidroquinona e carbonato de potassio liquido e cor vermelh; servicos de instalacao da maquinaria e dos equipamentos medicos profissionaise instrumentos de precisao e o;34;387;108;279
906;tinta  guache  500  ml para  trabalhos  artisticos eescolares  nao  e  toxica  soluvel  em  agua  e  disponivel em  13  cores  quesao  misciveis  entre  si  aplicavel  em papel    papel    cartao    cartolina    gesso    madeira    e ceramica   conforme   portaria   inmetrono   3332012 e registro 0021882014 cores vari; servicos de instalacao da maquinaria e dos equipamentos medicos profissionaise instrumentos de precisao e o;34;319;108;211
171;agua mineral natural sem gas ? 500 ml acondicionada em garrafa pet tampa crosca e lacre contendo 500 ml pacote com 12 unidades validade de 11 meses a contar da data da entrega suas condicoes deverao estar de acordo com o dec 3029 de 160499 e rdc 274 de 22092005 e suas alteracoes posteriores produto sujeito a verificacao no ato da entrega aos procedimentos administrativos determinados pela anvis; servicos do comercio por atacado prestado por comissao o contratode livrosrevistasperiodicos e artigos de escritori;33;397;116;281
221;agua sanitaria alvejante desinfetante de uso geral frasco com 1 litro com cloro ativo composicao hipoclorito de sodio carbonato de sodio e agua devera constar no rotulo do produto dados de identificacao do fabricante modos de utilizacao instrucoes para uso do produto codigo de barras no da autorizacao de funcionamento do fabricante na anvisa quimico responsavel e seu respectivo crq data de validade numero do lote e data de fabricaca; servicos do comercio por atacado prestado por comissao o contratode livrosrevistasperiodicos e artigos de escritori;33;436;116;320
561;formula enteral eou oral especializada liquida nutricionalmente completa normocalorica densidade calorica 10 a 12 kcalml hiperproteica >20% normoglicidica 5060% normolipidica 2535% isenta de sacarose lactose e gluten osmolaridade entre 200390 mosml de agua micronutrientes de acordo com as rdis com validade prolongada embalagem de 1 litro  sistema aberto tetrapack; maquinas especializadas para fabricacao  de  semicondutorescircuitos microeletronicos e placas de c;33;365;100;265
629;latex pva premium 3 6 litros latex premium 36 litros diluido a base de agua potavel  aplicacao em alvenaria reboco concreto gesso fibrocimento e texturas em areas internas e externas  secagem ao toque de 1 hora entre demaos de 2 horas  cobertura de 2 a 3 demaos  rendimento de 76m2 por galao  marca sugerida lukscolor ou similar em qualidade  apresentar catalogo no prega; equipamentos para contramedidas eletronicas  contracontramedidas e de capacidade de reacao rap;33;371;95;276
715;margarina vegetal contendo agua oleos vegetais liquidos e hidrogenados sal leite em po desnatado vitamina a e beta caroteno estabilizantes mono e diglicerideos e esteres de poligliceral aroma identico ao natural de manteiga corante natural de urucum e curcuma acidulantes acido latico e acido citrico e antioxidante edta calcio dissodico embalagem de 500 gr; equipamentos para contramedidas eletronicas  contracontramedidas e de capacidade de reacao rap;33;357;95;262
740;papel crepado 50x50 oferece barreira microbiana eficaz atraves das porosidade  eficiente na filtracao bacteriana  maleavel  reisistente a ruptura  rasgo e estouro  biodegradavel e incineravel  confeccionado em 100 celulose  atoxico e nao irritante  alta barreira contra penetracao de microorganismo  alta resistencia a agua hiporepelente  virtualmente livre de fibras antiestatico nao liberado ou atraindo particul; servicos para  a  infraestrutura de tecnologia da informacaoe comunicacao tic  nao classificados em outros top;33;414;111;303
762;postes para fixacao de  placas fornecimento e assentamento de tubos para fixacao de placas de sinalizacao viaria nas seguintes caracteristicas e dimensoes  tubo em aco carbono sae 10101020 galvanizado a quente grau c secao circular com costura e pontas lisas diametro  de 300 m de comprimento de 2 ?  devera ser colocado um tampao na parte superior do tubo evitando a entrada de agu; servicos para  a  infraestrutura de tecnologia da informacaoe comunicacao tic  nao classificados em outros top;33;382;111;271
824;sabao em po embalagem de 1kg composicao alquil benzeno sulfonato de sodio alquil dimetil hidroxietil cloreto de amonio tripolifosfato de sodio silicato de sodio carbonato de sodio carboximetilcelulose de sodio pigmento azul 44'bis 2  sulfoestiril binenicol dissodico acido 44 diamino estilbeno n22 dissulfonico sulfato de sodio silicone enzimas perfume e agu; unidades de propulsao inertes a combustivel solido de veiculos espaciais e misseis guiados e seus c;33;358;100;258
826;sabonete liquido de boa qualidade destinada a limpeza suave das maos e do rosto ph 100% 55 ? 60 aparencia e odor liquido azul perolado e perfumado densidade 1005 ? 1008 gcm3 viscosidade 1000  15000 cps viscosimetro fungilab visco basic spindle 320 rpm temperatura 20o a 25o solubilidade na agua 100% sem diluir pronto para usar embalagem galao de 5 litr; servicos de instalacao da maquinaria e dos equipamentos medicos profissionaise instrumentos de precisao e o;33;353;108;245
838;serra para cortar pisoasfalto a gasolina 4t  diam disco diam furomm 350254mm  rotacao maxima do disco de 3600rpmprofundidade de corte de 0mm a 120mm potencia do motor de 9hpa 15hp  4 tempos tanque de combustivel l 53 capacidade do tanque de agua l 15 peso 93kg dimensoes do equipamentocxlxa mm 1650x480x950; instrumentos para medicao de fluxo de liquido e  gas  nivelde liquidos e de movimentos mecan;33;306;93;213
841;servico de contratacao de 01 um caminhao pipa com capacidade minima de 80 mil litros para transportar e abastecer agua potavel as seguintes localidades assentamento divididatabuleirinho e grota do escuro durante o periodo de 12 doze meses atendendo as necessidades basicas de aproximadamente 100 familias dessas comunidades rurais desse municipio que nao dispoe de sistema adequado de abastecimento de agua e nem estao proximas a nascentes ou riach; servicos do comercio por atacado prestado por comissao o contratode livrosrevistasperiodicos e artigos de escritori;33;448;116;332
860;suco de fruta sabor caju de primeira qualidade concentado nao alcoolico nao fermentado sabor caju ingredientes agua potavel concentrado de caju aromatizantes  aroma identico ao natural de caju acondicionado em recipientes apropriados original de fabrica com aproximadamente  500 ml com informacoes do fabricante e data de vencimento estamapado na embalagem embalagem c  de 500 ml c; servicos do comercio por atacado prestado por comissao o contratode livrosrevistasperiodicos e artigos de escritori;33;381;116;265
898;tela de projecao eletrica 4x3 100?? caracteristicas tela eletrica serie a nao intercambiavel com sensor de corrente nao possui moldura formato 43 video limpeza do tecido e feita com sabao neutro e agua voltagem disponivel 110v modelos tem100va area de projecao 2030x1520mm comprimento do estojo 2315mm dimensoes entre furos 2295mm altura 1640mm; servicos para  a  infraestrutura de tecnologia da informacaoe comunicacao tic  nao classificados em outros top;33;344;111;233
167;agua mineral sem gas 200ml  informacoes adicionais produto de boa qualidade potavel com tampa aluminizada e deve estar acondicionada em copo plastico nao toxico intacto desinfetado sem evidencias de violacao de remendos manchas ou amassadose rotulados na origem com marca classificacao fonte de procedencia prazo de validade data de envase caracteristicas fisicoquimicas e demais informacoes exigidas na legislacao em vigor  fornecimento embalagem contendo 48 copos de 200ml c; servicos do comercio por atacado prestado por comissao o contratode livrosrevistasperiodicos e artigos de escritori;32;476;116;360
254;bebedouro de pressao capacidade de refrigeracao de 6lh deposito de agua em aco inox com serpenti bebedouro de pressao capacidade de refrigeracao de 6lh deposito de agua em aco inox com serpentina externa dreno para limpeza da cuba torneira em latao cromado copo e jato ralo sifonado tampo em inox polido gabinete em aco inox controle automatico da temperatura filtro de agua com carvao ativado serve ate 40 pessoash voltagem 127120v; servicos do comercio por atacado prestado por comissao o contratode livrosrevistasperiodicos e artigos de escritori;32;432;116;316
258;bebedouro industrial 03 torneiras capacidade 200 litros com cuba de 11 litros 110v modelo em aco inox com 02 torneiras copo e 01 torneira esguicho com cuba injetada e pp de alta resistencia facil instalacao com filtro embutido manutencao simples acompanhada de mangueira conectores e tubo de despejo cuba com armazenamento de agua sem necessidade de saida ou esgoto capacidade de retencao de agua 11 litr; equipamentos para contramedidas eletronicas  contracontramedidas e de capacidade de reacao rap;32;404;95;309
463;contratacao de veiculo tipo onibus minimo 36 lugares ano de fabricacao 2007 acima linha de transporte escolar municipal n 1201 percurso diario 94000 kms no itinerario faz do nivaldo pedras faz ana br 251 coagril aeroporto trevo agua branca rio preto unai para a e e virgilio de melo franco  e e vigario torres  unimontes no horario da t sendo 245 dias letivos e escolares no periodo de 0102 ate 31122022; servicos do comercio por atacado prestado por comissao o contratode livrosrevistasperiodicos e artigos de escritori;32;403;116;287
486;coxa e sobrecoxa de frango coxa e sobrecoxa de frango corte de frango deve apresentarse com carimbo de inspecao do orgao competente nao deve apresentar gelo superficial agua dentro da embalagem nem qualquer sinal de recongelamento gelo de cor avermelhada por exemplo nao podem ter manchas de qualquer especie nem parasitos nem larvas o sabor e o odor devem ser caracteristicos a cor deve ser rosada sem tempero congel; servicos do comercio por atacado prestado por comissao o contratode livrosrevistasperiodicos e artigos de escritori;32;417;116;301
526;extintores de incendio extintores de agua pressurizada extintor de agua pressurizada capacidade extintora 2a sistema de protecao por extintores de incendio  tipo portatil fabricado conforme nbr 158082010 pintura vermelha aplicada por processo eletrostatico carga 10l tempo de descarga 50 a 60 segundos pressao de trabalho 10 mpa peso bruto com carga 14 kg comprimento de mangueira de 650 mm; servicos do comercio por atacado prestado por comissao o contratode livrosrevistasperiodicos e artigos de escritori;32;390;116;274
633;leite uht integral zero lactose leite uht ou longa vida integral para dietas com restricoes de lactose submetido a altas temperaturas durante o seu processo de fabricacao porem com a preservacao de seus nutrientes ausencia total de bacterias e antibioticos e nao deve apresentar adicao de agua o leite deve atender as caracteristicas sensoriais exigidas pelo regulamento tecnico de identidade e qualidade de produtos lacteos do ministerio da agricultura pecuaria e abastec; servicos do comercio por atacado prestado por comissao o contratode livrosrevistasperiodicos e artigos de escritori;32;472;116;356
638;limpador multiuso domestico para limpeza pesada liquido  composto de linear alquilbenzeno sulfonato de sodio    tensoativo  nao ionico   alcalinizante    sequestranteeter   glicolico    perfume   e agua   com  validade  1  ano  a  contar  da  entrega   embalado  em frasco   plastico   contendo   500   mililitros   do   produto    laudo analitico do lote do produto e autorizacao de funcionamento do fabricante na anvis; servicos do comercio por atacado prestado por comissao o contratode livrosrevistasperiodicos e artigos de escritori;32;420;116;304
688;luvas de procedimentos tamanho medio em latex 100% natural nao esteril ambidestras resistentes com tensao de ruptura minima atendendo ao padrao 15 aql totalmente impermeavel a agua e a outros fluidos superficie lisa atendendo as exigencias da rdc no 05 de 15 de fevereiro de 2008 ca e lote impressos no punho ca = 13030 validade de 5 anos da data de fabricacao com registro na anvisa caixa com 100 un; servicos do comercio por atacado prestado por comissao o contratode livrosrevistasperiodicos e artigos de escritori;32;400;116;284
705;maquina de lavar gabinete zyncplus  em aco galvanizado cesto em polipropileno automatica capacidade de roupa seca 12 kg eficiencia energetica classe a velocidades de centrifugacao 750 rpm funcoes 12 programas de lavagem niveis de agua 4 sendo extra baixo baixo medio alto extras turbo agitacao economia duplo enxague lava edredom sistema de lavagem agitacao alimentacao 110 220 v; maquinas especializadas para fabricacao  de  semicondutorescircuitos microeletronicos e placas de c;32;379;100;279
735;pao de cenoura feito com produtos de 1a qualidade composto de farinha de trigo fortificada com ferro e acido folico cenoura acucar leite agua sal e fermento quimico peso unitario 50 g acondicionado em saco plastico atoxico com 20 unidades nao reciclavel fechados em perfeitas condicoes de higiene validade minima de 05 dias a partir da entrega demais condicoes de  acordo com as normas de saudesanitarias vigentes anvisa sif decreto 1248678 rdc 902000 e outr; servicos do comercio por atacado prestado por comissao o contratode livrosrevistasperiodicos e artigos de escritori;32;458;116;342
757;polikit potabilidade  kit desenvolvido para controle de qualidade da agua para consumo humano analise de dureza cloreto e alcalinidade com resolucao melhor do que o kit basico e tecnico ideal para monitoramento de agua em pocosanalisa alcalinidade cloretos dureza total ph ferro amonia cloro livre oxigenio consumido cor turbidez coliformes totais e colicolipaper tecnobac reagentes para 100 testes de cada parametro fisicoquim; servicos do comercio por atacado prestado por comissao o contratode livrosrevistasperiodicos e artigos de escritori;32;427;116;311
793;refrigerante sabor guarana em garrafa pet 02 litros sabor guarana possuir os seguintes ingredientes agua gaseificada acucar extrato de guarana acidulante acido citrico aromatizante corante caramelo iv  conservadores sorbato de potassio e benzoato de sodio  e para uma porcao de 200ml possuir em sua composicao o limite maximo de 11mg de sodio e minimo de 20g de acucares marca sugerida antartica ou similar em qualidade apresentar amostra no prega; servicos para  a  infraestrutura de tecnologia da informacaoe comunicacao tic  nao classificados em outros top;32;447;111;336
820;sabao em barra embalagem com 5 barras composicao sabao de acidos graxos de cocobabacu sabao de acidos graxos de sebo sabao de acidos graxos de soja linear alquil benzeno sulfonato de sodio coadjuvante glicerina agente antiredepositante fragrancia pigmentos e agua embalagem constando dados de identificacao do produto data de validade e registro no ministerio da saude apresentacao pacote com 5 barras de 200 gram; servicos do comercio por atacado prestado por comissao o contratode livrosrevistasperiodicos e artigos de escritori;32;413;116;297
859;suco de fruta liquido tipo nectar sabor de uva composto de agua suco concentrado de uva acucar aroma natural acidulante acido citrico e espessante goma xantana com as seguintes informacoes nutricionais por porcao de 200ml valor energetico 120kcal 503kj carboidratos 29 gramas sodio 76 miligramas sem adicao de conservadores sem gluten com fornecimento em embalagem tipo caixa multilaminada cartonada impressa de 1 litro validade maxima 01; servicos para  a  infraestrutura de tecnologia da informacaoe comunicacao tic  nao classificados em outros top;32;438;111;327
39;070401  calha de chapa galvanizada no 24 desenvolvimento 33 cm                    condutor de agua pluvial e buzinotes sera medido por comprimento instalado m o item remunera o fornecimento de materiais e mao de obra para instalacao de tubo na cor branca condutores verticais e executadas com pvc reforcado com  as juntas com bolsa e anel de borracha inclusive materiais acessorios para emendas suportes juncao em outras pecas vedacao e fixaca; servicos do comercio por atacado prestado por comissao o contratode livrosrevistasperiodicos e artigos de escritori;31;443;116;327
248;barreira plastica  120x44x60cm composicao polietileno contra acao de desbotamentoprotecao contra raios uv e resistente as intemperies climaticascor laranjapossui 6 faixas com refletivo brancopeso 7kg vaziaaltura 60cmcomprimento 120mlargura 44cmencaixe machofemea para interligar uma peca a outrabase com 3 sapatas para escoamento de aguacompartimento interno para preenchimento com agua visando maior estabilidade e peso ao produtoempilha; servicos do comercio por atacado prestado por comissao o contratode livrosrevistasperiodicos e artigos de escritori;31;438;116;322
259;bebedouro industrial 100 litros  ou superior inox acq gabinete estrutural em aco inox 430 capacidade de armazenagem 100 litros ou superior compressor hermetico embraco isolamento termico eps filtro industrial pou 5 aparador de agua em aco inox 430 flexivel para escoamento embutido    torneira de alta resistencia em metal cromado gas refrigerante ecologico r134a termostato regulador de temperatura pes regulaveis tensao 127 ou 220 v torneira pressaojato opc; servicos do comercio por atacado prestado por comissao o contratode livrosrevistasperiodicos e artigos de escritori;31;459;116;343
275;biscoito salgado tipo creamcracker sem glute embalagem 400 gramas ingredientes cereal isento de gluten arroz fecula de mandioca etc leite gordura vegetal hidrogenada queijo agua ovos sal e aromatizante nao podera conter nenhum ingrediente que contenha gluten na embalagem devera conter as seguintes informacoes indicacao do fabricante ingredientes data de validade e peso validade minima de 12 meses a contar da data da entrega do produt; servicos para  a  infraestrutura de tecnologia da informacaoe comunicacao tic  nao classificados em outros top;31;437;111;326
736;pao de forma tipo tradicional pao de forma tipo tradicional superficie lisa  macia e brilhante  nao quebradica  mioloconsistente e peca fatiada  composto de farinha de trigo acucar  gordura vegetal  leite em po  sal  reforcador  agua fermento biologico e antimofo  embalado em saco plasticoatoxico com validade minima de 05 dias a contar da data deentrega  produto sujeito a verificacao no ato da entrega aosprocedimentos administrativos determinados pela anvis; servicos do comercio por atacado prestado por comissao o contratode livrosrevistasperiodicos e artigos de escritori;31;461;116;345
925;tinta latex a base  agua para uso em interiores e exteriores tinta latex a base  agua para uso em interiores e exteriores  linha premium  aprovado pelas normas da abrafati  e pela a abnt com iso 9001   lata de 18 litros  com rendimento por lata entre 250m2 e 380m2 por demao em superficie de massa corrida eou 200m2 e 380m2 por demao em superficie de reboco  com disponibilidade para todo tipo de cor  sugestao suvinil ou cor; servicos do comercio por atacado prestado por comissao o contratode livrosrevistasperiodicos e artigos de escritori;31;425;116;309
932;tinta para tecido cor verde 250 ml tintas a base de resina acrilica nao toxicas e soluveis em agua prontas para uso sao resistentes a lavagens e todas as cores sao misciveis entre si sua aplicacao pode ser feita com pincel ou esponja e tem fixacao a frio sao tintas desenvolvidas para tecidos de fibras naturais de algodao nao devendo ser utilizadas sobre tecidos sinteticos ou engomados pote contendo 250ml de tinta na cor verde igual ou superior a acrilex; servicos do comercio por atacado prestado por comissao o contratode livrosrevistasperiodicos e artigos de escritori;31;457;116;341
244;bandagem pronta para bota de unna composta por bandagem de 100  bandagem pronta para bota de unna composta por bandagem de 100   algodaotecido nao esteril inelastica embalada individualmente impregnada  com pasta contendo oxido de zinco a 10  agua destilada glicerol alcool  ceto estearilico cetomacrogol oleo mineral goma de guar goma de xantina  metilparahidroxibenzoato e propilparahidroxibenzoato  75 cm x 6 m; servicos para  a  infraestrutura de tecnologia da informacaoe comunicacao tic  nao classificados em outros top;30;413;111;302
256;bebedouro eletrico com suporte para agua mineral com 02 torneiras e ajustes de temperatura capacidad bebedouro eletrico com suporte para agua mineral com 02 torneiras e ajustes de temperatura capacidade do reservatorio de 23 litros tensao 110 220 serpentina externa facilitando a limpeza ajuste de temperatura botao de termostato externo plastico em alto impacto aliando a chapa de aco carbono pintado ou inox funil separador altura 97cm largura 300cm profundidade 31cm e peso 1240 quil; servicos do comercio por atacado prestado por comissao o contratode livrosrevistasperiodicos e artigos de escritori;30;486;116;370
263;bebedouro industrial fabricado em aco inoxidavel dupla isolacao termica em poliuretan bebedouro industrial fabricado em aco inoxidavel dupla isolacao termica em poliuretano sistema hidraulico projeta conforme as normas da abnt tripla filtragem contendo 03 torneiras em aco inoxidavel regulagem externa termostato condensador duplo baixo aquecimento compressor hermetico sedicioso  devendo eliminar gostos odores e impurezas a partir de 05 micras  com capacidade para 200 litros de agua gelada p hora com bojo garantia minima de 01 ; servicos do comercio por atacado prestado por comissao o contratode livrosrevistasperiodicos e artigos de escritori;30;531;116;415
273;biscoito infantil sem gluten sem lactose e sem ovos ingredientes farinha de milho farinha de arroz margarina vegetal [gorduras e oleos vegetais palma palmiste coco canola em proporcoes variaveis agua sal emulsificante mono e diglicerideos de acidos graxos aromatizante] acucar fecula de batata amido de milho xarope de beterraba amido de arroz fermentos quimicos bicarbonato de amonio bicarbonato de sodio amido de milho modificado sal aromatizante embalagem de no minimo 125g; servicos de leasing ou aluguel de televisores radios gravadores de video e equipamentos e acessorios correlat;30;476;110;366
277;biscoito sem lactose 400g ingredientes farinha de trigo enriquecida com ferro e acido folico acucar agua gordura vegetal hidrogenada zero trans acucar invertido estabilizante lecitina de soja fermentos quimicos sal metabissulfito de sodio aroma artificial de baunilha proteinases vitaminas b1b2b6 e pp sem colesterol sem lactose e sem proteina do leite isento de produtos de origem animal contem gluten alergicos contem trigo pode conter derivados de cevada aveia soja e centeio caixa com 20 unidades de 400g; servicos do comercio por atacado prestado por comissao o contratode livrosrevistasperiodicos e artigos de escritori;30;508;116;392
298;bola futebol campo termotec  genero  unissex tipo campotecnologia termotec definicao da tecnologia com 0% de absorcao de agua a tecnologia permite o uso da bola em condicoes de chuva intensa garantindo a precisao e leveza na hora do chute composicao poliuretano peso do produto 410450 g costura sem costura circunferencia 6870 cm garantia do fabricante 30 dias defeito de fabricacao origem nacional similar ou de qualidade superior a marca e modelo penalty s11 r1 ou penalty brasil 70 pr; servicos do comercio por atacado prestado por comissao o contratode livrosrevistasperiodicos e artigos de escritori;30;487;116;371
340;bota de unna bandagem inelastica impregnada por oxido de zinco  em rolo agua destilada glicerol alcool ceto estearilico cetomacrogol oleo mineral goma de guar goma de xantina metil para microxiloenoato e propilpara hidroxiloenoato bandagempara bota de unna composta por algodao nao tecido inelastica embalada individualmente impregnada com pasta contendo oxido de zinco 10% agua destilada gliceriol goma de guar goma de xantina tamanho  75 cm x 9 metr; servicos do comercio por atacado prestado por comissao o contratode livrosrevistasperiodicos e artigos de escritori;30;451;116;335
432;carro funcional de limpeza fabricado com polipropileno  resistente bolsa de vinil com abertura frontal sistema de fixacao  para diversos tipos de acessorios acompanhado de balde com  rodas e divisor de agua limpa e suja com espremedor e  capacidade minima de 30 litros pa coletora de lixo basculante  placa sinalizadora  cuidado! piso molhado  armacao mop profi  com 40 cm feita em polipropileno de alta resistencia com  estrutura em aco galvanizado 2 cabos de aluminio com 140 cm e  haste americana para mop liqu; servicos do comercio por atacado prestado por comissao o contratode livrosrevistasperiodicos e artigos de escritori;30;513;116;397
693;macarrao penneproduto nao fermentado pelo amassamento mecanico de farinha de trigo comum eou semolasemolina enriquecido com ferro e acido folico corante natural de curcuma e urucum as massas ao serem postas na agua nao deverao turvalas antes da coccao nao podendo estar fermentadas ou rancosas com rendimento minimo apos o cozimento de 2 vezes a mais do peso antes da coccao embalagem de 500 gramas transparente e apresentar data de val; servicos do comercio por atacado prestado por comissao o contratode livrosrevistasperiodicos e artigos de escritori;30;436;116;320
704;maquina de lavar roupas   11 kg especificacoes  tecnicas largura 61cm altura 100cm profundidade 65cm peso 365kg lavadora de roupas consumo 031kwh cor branco garantia 12 meses cesto inox com base plastica capacidade total  kg  11 abertura da tampa superior pes niveladores sim temperatura da agua fria ciclos de lavagem 16 programas niveis de agua 4 niveis display eletronico funes lava enxagua centrifuga consumo aproximado de agua 130l filtro sim centrifugao 750 rpm potencia 850w  ; servicos do comercio por atacado prestado por comissao o contratode livrosrevistasperiodicos e artigos de escritori;30;483;116;367
772;purificador de agua refrigerado e com reservatorio purificador com volume interno para agua podendo encher jarras e garrafas com mais facilidade com saida para agua natural e refrigerada eliminam sabores e odores da agua eficiencia de retencao de particulas eficiencia de reducao de cloro livre bandeja removivel facilitando ainda mais no momento da limpeza do equipamento purificador bivolt de bancada ou de parede proporcionando assim maior seguranca do equip; servicos para  a  infraestrutura de tecnologia da informacaoe comunicacao tic  nao classificados em outros top;30;461;111;350
779;refletor led 400w branco frio uso externo especificacoes tecnicas consumo 400w tensao bivolt automatico 100v 240v cor da luz branco frio 6000k luminosidade 38000 lumens com variacao de 10% angulo de iluminacao 100deg indice de protecao ip66 protecao contra jatos de agua forte e poeira vida util 40000 horas medidas aproximada 24cm x 53cm x 33cm peso aproximado 11000 gramas material aluminio itens inclusos refletor com o suporte articulavel garantia 1 ; servicos do comercio por atacado prestado por comissao ou   por contratode produtos farmaceuticos e med;30;454;104;350
901;tenda 10x10 modelo piramide ou chapeu de brucha coberta com lona de vinil autoextinguivel com calhas nas laterais para escoamento da agua com pe direito com opcao de montagem de 3 a 6 mts de altura conforme solicitacao na data do evento todo o material deve estar em otimo estado de conservacaofica a cargo da comissao organizadora qual modelo que ira solicitar para o eventoa empresa deve apresentar registro no crea para participar do certame e na data do evento apresentar a respectiva art preco por di; servicos do comercio por atacado prestado por comissao o contratode livrosrevistasperiodicos e artigos de escritori;30;505;116;389
85;adesivo bsn medical transparente para fixacao adesivo bsn medical transparente para fixacao de curativos rolo 10cm x 10m adesivo transparente hipoalergenico utilizado para fixacao de curativos drenos e cateteres e composto por um filme transparente que adaptase ao contorno da pele sem prejudicar sua respiracao ou causar irritacoeso adesivo transparente protege as feridas do contato com agua umidade e contaminacao permitindo que os pacientes mantenham as suas atividades normais com a agua como por exemplo o banh; servicos para  a  infraestrutura de tecnologia da informacaoe comunicacao tic  nao classificados em outros top;29;516;111;405
136;agua mineral  natural sem gas  acondicionada em garrafao de 20 litros garrafao fabricado em resina virgem com tampa de pressao e lacre  contendo 20 litroscom validade minima de 2 meses a contarda data da entrega  sem vasilhame  suas condicoes deverao estar de acordo com o dec3029 de 160499  rdc274 de 220905portaria 387 de 190908  abntnbr 14328 de 18122011 e abnt nbr 14222 de 22042013 e suas alteracoes posteriores  produto sujeito a verificacao no ato da entrega aos procedadministrativos determinados pela anvis; servicos do comercio por atacado prestado por comissao o contratode livrosrevistasperiodicos e artigos de escritori;29;515;116;399
517;equipamento de tratamento biologico de esgoto  unidade basica de saude ubs na comunidade de campestre  para atender ao tratamento de esgotamento sanitario dos predios publicos e residencias da area rural de ouro brancomg fabricado em fibra de vidro prfv para o tratamento diario do efluente gerado por 24 pessoas no total de 315m3 de efluente com capacidade para tratamento de esgoto domestico agua cinza e agua negra a ser instalado na unidade basica de saude ubs na comunidade de campestr; equipamentos para contramedidas eletronicas  contracontramedidas e de capacidade de reacao rap;29;490;95;395
525;extintor incendio agua  extintor agua pressurizada 10l carregado novo em conformidade com as nbr produto com certificado de conformidade emitido por organismo de certificacao de produto ocp credenciado pelo inmetro o extintor devera possuir pino preso com corrente metalica em seu gatilho lacre etiqueta de identificacao presa em seu bojo com material de dificil ruptura com no minimo os seguintes dados preenchidos tipo de extintor capacidade no de fabricacao no do selo inmetro carregado em proxima recarga teste hidrostatico proximo teste hidrostatico com suporte de parede complet; servicos do comercio por atacado prestado por comissao o contratode livrosrevistasperiodicos e artigos de escritori;29;584;116;468
664;lixeira individual  coleta de copos descartaveis  lixeira individual  tipo coleta de copos descartaveis de agua e cafe material pvc  poliestireno de alto impacto capacidade 300 copos cada aproximadamente formato cilindrica cor brancatampa sem tampa pedal sem pedal alca sem alca rodas sem rodas dimensoes aproximadas 75 cm de altura 195 cm de largura 12 cm deprofundidade 55 cm de diametro do tubo para copo de cafe 50 ml e85 cm de diametro do tubo para o copo de agua 200ml; servicos para  a  infraestrutura de tecnologia da informacaoe comunicacao tic  nao classificados em outros top;29;474;111;363
690;macacao para protecao do tronco e membros superiores e inferiores modelo tipo jardineira produto formado por um conjunto completo macacao botas e luvas acopladas o macacao e totalmente impermeavel inclusive nas botas e luvas que deverao ser selados ao macacao seu uso e indicado para risco proveniente de agua e contaminantes que podem agredir a pele do usuario devem ser confeccionado em pvc grosso kp 400 o suficiente para protecao de inumeros contaminantes sua cor deve ser amarela com ca certificado de aprovacao do mte ministerio do trabalho e empreg; servicos do comercio por atacado prestado por comissao o contratode livrosrevistasperiodicos e artigos de escritori;29;555;116;439
712;margarina  margarina vegetal cremosa com sal embalagem 500gr  margarina  margarina vegetal cremosa com sal obtida como resultado da emulsao de oleos eou gorduras vegetais comestiveis e sal refinado o produto devera ter 15000 ui de vitamina a por kg conteudo maximo de agua de 16  sobre o peso bruto  a  embalagem o produto devera estar acondicionado em embalagem primaria de polietileno fechado por metodo que garanta a inviolabilidade do produto com peso liquido de 500  quinhentos  gram; servicos do comercio por atacado prestado por comissao o contratode livrosrevistasperiodicos e artigos de escritori;29;488;116;372
714;margarina vegetal  500 g cremosa com sal isenta de ranco e mofos embalagem atoxica nao violada composicaooleos vegetais liquidos e interesterificadosaguasalsoro de leite em po contem lecitina de soja e no minimo 80% de lipideos aroma identico ao natural de manteiga contendo dados do produto identificacao procedencia ingredientes informacoes nutricionais lote gramatura datas de fabricacao e vencimentoacondicionado em pote plastico validade minima de 6 seis meses a contarda data de entrega do produto portaria 372 de 04091997  anvis; servicos do comercio por atacado prestado por comissao o contratode livrosrevistasperiodicos e artigos de escritori;29;535;116;419
845;servico de desinfeccao quimica e limpeza geral de caixa d'agua e reservatorio d'agua no cem  rosa mameria rade  rodovia mg 223 km 12  pov alto sao joao  2 caixa d'agua de fibra elevadas de 1000 l e de 3000 l unidade situada na zona rural auma distancia de 15 km da sede da secretaria de educacao a cada execucao deverao ser emitidos os laudos tecnicos elaborados por profissional devidamente registrado no conselho regional de quimica e no ministerio da saude conforme exigencia da portaria rdc n 21614 da vigilancia sanit; servicos do comercio por atacado prestado por comissao o contratode livrosrevistasperiodicos e artigos de escritori;29;522;116;406
874;tala aramada para imobilizacao tamanhogg tal tala aramada para imobilizacao tamanhogg tala aramada para imobilizacao confeccionda em eva 4mm colorida para identificar seu tamanho nas cores padrao para resgatepode ser usada com fita crepe bandagem ou gaze para imobilizacao completa e usada para imobilizacao provisoria no resgate e transporte de acidentados nao requer agua quente ou vapor para sua aplicacaopode ser lavada e reutilizadatamanho gg 102x11cm v; servicos do comercio por atacado prestado por comissao o contratode livrosrevistasperiodicos e artigos de escritori;29;458;116;342
18;0000000000000000000000000000000000000000000000000000000000000000000000000000000000000000000000000000000420024 bebedouro de agua eletrico que comporta galao d; acessorio de gerador eletrico de motor de aeronav;28;157;50;107
266;bebida lactea achocolatado tradicional 200 ml bebida lactea achocolatado tradicional 200 ml bebida lactea  sabor chocolate  constituido por leite reconstituido  soro de leite  agua  acucar  cacau em po  minerais  calcio  magnesio e ferro   vitaminas  c  b1  b2  niacina  b6  b12  acido pantotnico  biotina   sal  espessantes carragena  goma xantana e carboximetilcelulose sodica  aromatizantes e acidulante acido citrico  pronto para consumo  embalado em caixa longa vida com 200ml 25981; servicos para  a  infraestrutura de tecnologia da informacaoe comunicacao tic  nao classificados em outros top;28;487;111;376
407;calcado caracteritico calcado caracteristicas calcado para protecao contra impactos de quedas de objetos sobre os artelhos  calcado para protecao dos pes contra agentes termicos  calcado para protecao dos pes contra agentes abrasivos e escoriantes  calcado para protecao dos pes contra agentes cortantes e perfurantes  calcado para protecao dos pes e pernas contra umidade proveniente de operacoes com uso de agua  calcado para protecao dos pes e pernas contra respingos de produtos quimicos impermeabilizados com ponta reforcada com aco numeros de 35 a 46 conforme necessidade especificada no ped; servicos do comercio por atacado prestado por comissao o contratode livrosrevistasperiodicos e artigos de escritori;28;597;116;481
442;cesta basica  contendo os seguintes produtos 02 pacotes de 250 gramas de cafe moido e torrado com selo abic 02 kg de acucar cristal 01 pcte de 05 kg de arroz branco polido tipo 1 02 kg de feijao carioca tipo 1 1 kg de farinha de mandioca torrada e moida clara 02 latas de oleo de soja 0  de gordura trans sem colesterol 01 pacote de 1 kg de macarrao tipo espaguete 01 pacote de 01 kg de sal moido iodado fino 01 achocolatado em po 200 gramas 01 biscoito agua e sal tipo cream crack 400 g 01 leite em po pcte 200 gram; servicos do comercio por atacado prestado por comissao o contratode livrosrevistasperiodicos e artigos de escritori;28;516;116;400
489;curativo filme transparente placa 6x7cm filme de poliuretano transparente hipoalergenico alta per curativo filme transparente placa 6x7cm filme de poliuretano transparente hipoalergenico alta permeabilidade ao vapor permitindo trocas gasosas e impermeavel a agua e microorganismos de facil visualizacao e inspecao do sitio de insercao do cateter e que ofereca boa estabilidade prevenindo a sua migracao esteril embalado individualmente tamanho aproximado de 6 x 7cm validade e esterilizacao nao inferior a 2 anos cota reservada a meepp; servicos do comercio por atacado prestado por comissao o contratode livrosrevistasperiodicos e artigos de escritori;28;535;116;419
669;locacao de tenda tendas 5x5 com fechamento e balcao  02 diarias contendo cobertura tipo chapeu de bruxa ou piramide de cor branca fechamento em lona de pvc de alta resistencia com protecao uv antichamas e autoextinguivel com 4 fechamentos laterais servico de calha para o escoamento de agua e dois balcoes tamanho 5m de largura por 120m de altura um em cada lateral da tenda incluso  transporte montagem desmontagem  equipe tecnica seguro responsabilidade civil pela seguranca dosequipamentos e todas as despesas referentes as diarias acomodacoes e alimentacao dos funcionari; servicos do comercio por atacado prestado por comissao o contratode livrosrevistasperiodicos e artigos de escritori;28;575;116;459
722;milho verde em conserva 1kg  graos inteiros  com tamanho e forma regulares  sem aditivos quimicos  conservados em agua e sal  livre de fermentacao  isento de materia terrosa  de parasitos e de detritos animais e vegetais  o produto  inclusive o liquido de cobertura devem ocupar  no minimo  90  da capacidade do recipiente  aparencia  graos inteiros de consistencia propria  nao esmagados  cor  cheiro e sabor proprios  validade minima de 12 meses   embalagem primaria lata de folha de flandres  com verniz sanitario  com peso liquido drenado de 1 kg; servicos do comercio por atacado prestado por comissao o contratode livrosrevistasperiodicos e artigos de escritori;28;550;116;434
73;acido fluossilicico para tratamento de agua com as seguintes caracteristicas aspecto claro e limpido  teor de h2s1fs minimo de 20% em massa  densidade 120 gml  acidez livre maximo de 1%material em suspensao isento  teor de ferro total maximo 10gkgteor de manganes total maximo 10gkg  toxicidade os limites de toxicidade forma calculados para uma dosagem maxima de 625 mgl ppm de acido fluossilicido a 20% arsenio maximo 800mgkg cromo maximo 800mgkg chumbo maximo 800 mgkg o produto devera ser entregue em bomb; servicos para  a  infraestrutura de tecnologia da informacaoe comunicacao tic  nao classificados em outros top;27;509;111;398
284;bloqueador inflavel  bloqueador inflavel para tubos de 200 a 400mm completo em tubulacoes de agua ou esgoto nos servicos de manutencao com rede em carga sera fornecido completo com manual o nome ou marca de identificacao do fabricante devera ser gravado de forma visivel e indelevel bloqueador inflavel fabricado com aramida com borracha natural super resistente kevlar com ranhuras diametro 200mm a 400mm aneis resistentes para a conexao de cabo para icamento engate rapido de entrada para inflar o bloqueador pressao de trabalho 25 bar diametro vazio 192mm comprimento 635mm peso 30 kg; servicos do comercio por atacado prestado por comissao o contratode livrosrevistasperiodicos e artigos de escritori;27;587;116;471
433;carro maca hospitalar estrutura em tubo de aco carbono redondo  leito estofadocom espuma revestido em courvim d28 na cor verde agua cabeceira regulavel atraves de cremalheira  grades laterais de abaixar em tubo de aco inox  suporte parasoro com 02 ganchos t acabamento em pintura epoxi com tratamento antiferruginoso parachoque de protecao na cabeceira e pes rodizios de 5  em polipropileno com sistema de freio em diagonal medindo 190 m de comprimento x 060 m delargura e 080 m de altura capacidade de peso de no minimo 130 kg garantia deno minimo 01 ano registrado na anvis; servicos do comercio por atacado prestado por comissao o contratode livrosrevistasperiodicos e artigos de escritori;27;575;116;459
520;espargidor de emulsao asfaltica a frio modelo ep 2500tanque com capacidade de 2500 litros de emulsao a frio nao termico equipado com tampa para inspecao e limpeza bomba de asfalto de 1 12 comprimento da mangueira espargidora lonada 65 metros caneta e bico espargidor de aco sistema de limpeza do circuito do asfalto atraves de oleo diesel com reservatorio de 10 dez litros e 40 quarenta litros de agua equipamento com valvula de alivio manometro medidor de nivel e dispositivo para auto abastecimento equipado com 01um eixo com 02 duas rodas e pneus novos 750x 16; servicos do comercio por atacado prestado por comissao o contratode livrosrevistasperiodicos e artigos de escritori;27;563;116;447
589;iogurte sem lactose leite reconstituido integral eou leite pasteurizado integral preparado de morango agua polpa de morango amido modificado aromatizantes corante natural carmim espessantes goma xantana e goma guar conservador sorbato de potassio acidulante acido citrico e edulcorante sucralose amido modificado enzima lactase fermento lacteo e espessante gelatina  data de fabricacao e prazo de validade de no minimo 30 dias com registro no ministerio da agricultura  sif sabor de morango embalagem de filme flexivel de polietileno leitoso bandeja com 6 unidades de 90 g; servicos do comercio por atacado prestado por comissao o contratode livrosrevistasperiodicos e artigos de escritori;27;572;116;456
695;macarrao tipo ave maria ou padre nosso embalagem 1 kg produto nao fermentado obtido pelo amassamento mecanico de farinha de trigo comum eou semolasemolina fabricado a partir farinha de trigo enriquecida com ferro acido folico de materias primas sas limpas isentas de materia terrosas parasitos e larvas as massas ao serem postas na agua nao deverao turvalas antes da coccao nao podendo estar fermentadas ou rancosas com rendimento minimo apos o cozimento de 2duas vezes a mais do peso antes da coccao com validade minima de 3tres meses apos a dat; servicos do comercio por atacado prestado por comissao o contratode livrosrevistasperiodicos e artigos de escritori;27;546;116;430
207;agua sanitaria 1 litro  base hipoclorito de sodio  agua sanitaria solucao aquosa a base de hipoclorito de sodio  com teor de cloro ativo de 2   dois por cento  a 25   dois e meio por cento  durante o prazo de validade de 06 meses destinada tambem tambem a desinfeccao de agua para consumo humano hortifruticulas e caixas d agua embalagem deve ser opaca com tampa de rosca ou pressao devendo constar o percentual de hipoclorito numero de lote data de fabricacao  devendo ser proximo da data de entrega  o prazo de validade do produto diamesano e demais determinacoes exigidas pelo ministerio da saude acondicionada em frascos plasticos com 01 litr; servicos do comercio por atacado prestado por comissao o contratode livrosrevistasperiodicos e artigos de escritori;26;646;116;530
230;amaciante de roupas de 02 litrosamaciante de roupas 02 litros composicao componente cloreto de alquil dimetil amonio concentracao 2  10% no cas 61789808 componente mitcmit concentracao < 00015% no cas 55965849componente fragrancia comcentracao 010  10% nao apresenta casfragancia tradicional tensoativocationicoceramidasconservante umectante coranteopassificante fragancia e agua componente ativocloreto de alquildimetil amonico com hidraceramidas registro ms  rotulo em material resistente a agua e com informacoes claras que comunicam exatamente o que e o produto e para o que pode ser utilizado dermatologicamente test; servicos do comercio por atacado prestado por comissao o contratode livrosrevistasperiodicos e artigos de escritori;26;621;116;505
430;carne bovina acem congelado limpo livre de aponeuroses fascias musculares tendoes dedos e sebo  livre de adicao de agua  a embalagem devera ser do material atoxico devidamente aprovado pelo orgao oficial de inspecao  possuir selo ou solda inviolavel a embalagem secundaria sera na forma usual do fornecedor  os dizeres de rotulagem devem atender a inspecao oficial nome verdadeiro  do produto segundo nomenclatura oficial  endereco completo do fabricante  peso  liquido  rotulagem  nutricional conservacao datas de producao lote e vencimento  a validade dos cortes fornecidos devera estar ate um terco tomada ou dois tercos livres  ; servicos do comercio por atacado prestado por comissao o contratode livrosrevistasperiodicos e artigos de escritori;26;632;116;516
524;exclusivo me  agua mineral sem gas 20l  informacoes adicionais de primeira qualidade potavel oriunda de fonte natural fria com envase recente de data nao superior a 30 dias corridos contados a partir da data de entrega do produto e deve estar acondicionada em garrafoes plasticos adequados originais nao toxicos inodoros retornaveis intactos desinfetados lacrados sem evidencias de violacao de remendos manchas ou amassados e rotulados na origem com marca classificacao fonte de procedencia prazo de validade data de envase composicao quimica provavel e caracteristicas fisicoquimicas tampa de orelha com lacre de seguranca e protetor na parte superior  fornecimento galao contendo 20l; servicos do comercio por atacado prestado por comissao o contratode livrosrevistasperiodicos e artigos de escritori;26;685;116;569
567;frango coxa e sobrecoxa com osso congelado nao temperado aspecto firme nao amolecido e nem pegajoso coloracao amarelorosada sem escurecimento ou manchas esverdeadas nao deve haver formacao de gelo superficial agua dentro da embalagem e nem sinal de recongelamento gelo de cor avermelhada embalagens proprias plasticas transparentes resistentes devidamente seladas contendo identificacao do produto etiqueta com peso liquido prazo de validade numero de registro no sif ou ima o produto devera ser transportado refrigerado ou em caixas termicas que permitam manter o produto congelado temperatura para recebimento menor que 18oc; servicos do comercio por atacado prestado por comissao o contratode livrosrevistasperiodicos e artigos de escritori;26;626;116;510
680;luva esteril 80      luva em latex 100% natural anatomicas pulverizadas compo bioabsorvivel a base de amido de milho  superficie microtexturizada antideslizante totalmente impermeavel a agua e a outros fluidos    bainhas reforcadasresistentes com tensao de ruptura minima atendendoo padrao aql 15    alta sensibilidade e conforto com baixo teor de proteina menos de 100ppm por conteudo    embalagem tipo wallet indicando mao direita e esquerda    embalagem do parde luvas confeccionada em papel grau cirurgico de facil abertura  atoxica esterilizada por oxido de etileno   caixas c 200 p; servicos para  a  infraestrutura de tecnologia da informacaoe comunicacao tic  nao classificados em outros top;26;587;111;476
694;macarrao semola sem ovos talharim macarrao semola sem ovos tipo talharim  farinha de trigo enriquecida com ferro e acido folico 100g de farinha de trigo deve fornecer no minimo 42 mg de ferro e 150 mcg de acido folico rcd 344   131202 sem ovos corante natural de urucum e curcuma mais beta caroteno provitamina a adicionados com agua e submetidos a processo tecnologico adequado massa alimenticia em conformidade com a legislacao vigente contem gluten embalagem primaria de sacos em polietileno atoxica com conteudo liquido de no minimo 500 grs devidamente lacrado validade minima de 12 meses da entrega do produto o produto devera ter o selo da ab; servicos para  a  infraestrutura de tecnologia da informacaoe comunicacao tic  nao classificados em outros top;26;648;111;537
262;bebedouro industrial para agua refrigerada 100 litros com as caracteristicas minimas gabinete em ac bebedouro industrial para agua refrigerada 100 litros com as caracteristicas minimas gabinete em aco inoxidavel 304  capacidade de armazenamento de 100 lts  para uso de ate 200 pessoas dia  serpentina em aco inox com isolamento em poliuretano  03 torneiras em antimonio  sendo 02 para copo e 01 jato  termostato fixo com regulagem de temperatura para ajuste de 04 a 15 graus  voltagem opcional em 110 v e 220 v  compressor hermetico de 14 hp com gas ecologico r 134a  deve vir acompanhado de filtro siterizado de tripla aca; servicos do comercio por atacado prestado por comissao o contratode livrosrevistasperiodicos e artigos de escritori;25;623;116;507
403;caixa termica  c termometro fixo eficiencia termica > isolamento em poliuretano eficiencia termica muito maior do que as caixas com isolamento em eps isopor alca superior retratil > facil transporte tampa reversivel que serve de bandeja com 2 porta copos quando invertida caracteristicas gerais termometro digital de maxima e minima > instrumento de qualidade comprovada visor de facil leitura prova d`agua possui funcao ocof especificacoes caixa capacidade 47 litros dimensoes desconsiderando a alca comp x larg x alt 25 x 19 x 18 cm peso 720 g garantia 6 meses especificacoes termometro faixa de utilizacao 5070oc precisao  1oc entre 2050oc e  2oc acima de 50oc alimentacao 1 pilha aa inclus; servicos do comercio por atacado prestado por comissao o contratode livrosrevistasperiodicos e artigos de escritori;25;693;116;577
566;frango coxa e sobrecoxa congelado com cerca de 195 a 200g cada com adicao de agua de no maximo 6  aspecto proprio nao amolecido e nem pegajoso cor propria sem manchas esverdeadas cheiro e sabor proprio com ausencia de sujidades parasitas e larvas embalagem em saco de polietileno transparente atoxico limpo nao violado resistente que garanta a integridade do produto ate o momento do consumo contendo pacotes de 2kg acondicionados em caixas lacradas com 10kg devera constar na embalagem dados de identificacao procedencia informacoes nutricionais ndeg de lote data de validade quantidade do produto ndeg do registro no sif sie ou sim com prazo de validade minimo de 30 dias a partir da data de entreg; servicos do comercio por atacado prestado por comissao o contratode livrosrevistasperiodicos e artigos de escritori;25;700;116;584
825;sabonete liquido 05l para limpeza das maos com as seguintes propriedades fisicoquimicas ph 100%  55  60 aparencia e odor liquido azul branco ou verde perolado e perfumado densidade 1005  1008 gcm viscosidade 1000  15000 cps viscosimetro fungilab visco basic spindle 320 rpm temperatura 20 a 25  solubilidade na agua 100% diluicao pronto para usar sem diluir volatil fragrancia volatil apresentar registro do produto junto ao ministerio da saudeanvisa e autorizacao de funcionamento da empresa  afe no caso do licitante ser distribuidor apresentar afeanvisa como distribuidor apresentar ficha de informacao de seguranca de produto quimico  fispq de acordo com nbr 14725 contar galao 5 litr; servicos do comercio por atacado prestado por comissao o contratode livrosrevistasperiodicos e artigos de escritori;25;688;116;572
236;aparelhos e utensilios domesticos purificador de agua 36 litros  purificador voltagem 110220v e purificador de agua minimo 36 litros  purificador voltagem 127 v especificacoes minimas eficiencia energetica 008 kwl volume interno minimo 36 l fornecimento de agua gelada 12 lh temperatura de resfriamento 10 c a 50 f vazao maxima 60lh compressor tipo tripla filtragem medidas aproximadas de largura 30 cm altura 425 cm profundidade 49 cm peso aproximado 262kg caracteristicas adicionais agua gelada e natural aparelho ligado a rede de abastecimento de agua devera acompanhar todos os componentes necessarios para instalacao manual de utilizacao em portugues garantia de fabrica minima de 12 mes; servicos do comercio por atacado prestado por comissao o contratode livrosrevistasperiodicos e artigos de escritori;24;692;116;576
238;arla 32 litro  solucao de ureia certificada de alta qualidade e pureza e um reagente que utiliza juntamente com o sistema de reducao catalistica seletiva  rcs  para reduzir quimicamente as emissoes de oxido de nitrogenio presentes nos gases de escape dos veiculos a diesel e uma solucao de 325  ureia de alta pureza em agua desmineralizada que e transparente nao toxica e de manuseio seguro nao e explosivo inflamavel ou danoso ao meio ambiente e classificado como produto de categoria de risco minimo no transporte de fluidos nao e um combustivel ou um aditivo de combustivel e precisa ser utilizado em um tanque especifico em seu veiculo o abastecimento e feito em forme semelhante ao diesel; servicos do comercio por atacado prestado por comissao o contratode livrosrevistasperiodicos e artigos de escritori;24;693;116;577
295;bola campo society a peca possui 11 gomos fusionados atraves de uma camada de dupla colagem e conta com as tecnologias kick off neogel e termotec garantindo o quique ideal para grama alem disso sua camara 6d e fabricada com borracha butilica e apresenta 6 discos posicionados simetricamente assegurando maior equilibrio e alta precisao ja seu miolo lubrificado e removivel conta com o sistema capsula sis e carrega um bico alongado que isola a agulha e retem o ar kick off oferece maior precisao em passes e chutes menor quique e melhor controle para o jogador termotec 0% absorcao de agua e permite o uso da bola em condicoes de chuva intensa garantindo a precisao e leveza na hora do chute neogel; servicos do comercio por atacado prestado por comissao o contratode livrosrevistasperiodicos e artigos de escritori;24;698;116;582
296;bola campo a peca oferece um tecido ecologico desenvolvido a partir de fios de poliester reciclados de garrafas pet conta com a tecnologia termotec sem costura oferecendo formato 100% esferico com 0% absorcao de agua alta durabilidade e maciez extra ha ainda em sua estrutura o sistema neotec composto de amortecimento interno exclusivo com 45mm de espessura que proporciona maior conforto aos chutes e diminui o impacto no cabeceio alem disso o miolo e lubrificado e removivel e conta com o sistema capsula sis que isola a agulha e protege a camara composicao poliuretano tecnologia termotec miolo removivel e lubrificado costura nao origem nacional peso aproximado 430 450 g circunferencia aproximada 69  71 cm; servicos do comercio por atacado prestado por comissao o contratode livrosrevistasperiodicos e artigos de escritori;24;712;116;596
344;cabine  para ser utilizada em 03 tres ou mais dias de evento cabine de banheiro quimico em polie cabine  para ser utilizada em 03 tres ou mais dias de evento cabine de banheiro quimico em polietileno modelo standard equipado com papel higienico desinfetante quimico piso antiderrapante e sinalizacao livreocupado em perfeito estado nao sera aceita cabine com portas sem fechadura ou danificado o banheiro devera ter assepsia com caminhao tanque equipado com agua para higienizacao das cabines a limpeza devera ser completa durante todos os dias durante o evento uma unica vez por dia a empresa devera ter licenca ambiental apresentado juntamente com a proposta para comprovacao do tratamento dos dejet; servicos para  a  infraestrutura de tecnologia da informacaoe comunicacao tic  nao classificados em outros top;24;701;111;590
534;filtro de agua em aco inoxidavel 304 novo de fabrica devendo cumprir as minimas exigencias a seguir capacidade minima 1000 lh mil litros por hora no minimo 5 cinco camadas de cristais de quartzo com durabilidadetroca a cada 2 dois anos no minimo e carvao ativado sistema de retrolavagem a cada 15 quinze dias agua tratada sistema de retencao de particulas de areia argila e outras substancias organicas altura minima 1060 mm largura minima 310mm diametro minimo 250mm volume minimo 49 l a tubulacao do filtro devera ser toda de ? em aco inox soldado devera possuir selo de certificacao do inmetro garantia do aparelho de no minimo 03 tres anos de fabr; servicos do comercio por atacado prestado por comissao o contratode livrosrevistasperiodicos e artigos de escritori;24;651;116;535
582;grupo gerador de potencia minima de 7568 kva grupo gerador de potencia minima de 7568 kva intermitentecontinua fator de potencia 08 indutivo dotado de quadro de comando automatico na tensao de 220127vca  60 hz  motor diesel 4 ou 6 cilindros  sistema de amortecedores de vibracao  sistema de governo eletronico  sistema de arrefecimento  radiador  ventilador  e bomba centrifuga  filtros de ar tipo seco e lubrificacao com elementos substituiveis  sistema eletrico 12 vcc dotado de alternador para carga de bateria  sistema de protecao por termometro e pressostato alta temperatura da agua e baixa pressao  do oleo de lubrificacao  sistema preaquecimento  alternador trifasico sem escovas com regulador automatico de tensa; servicos do comercio por atacado prestado por comissao o contratode livrosrevistasperiodicos e artigos de escritori;24;721;116;605
706;maquina eletrica de cortar cabelo linha profissional fabricacao no brasil com identificacao do inmetro motor shunt super potente de 9 w  v9000 motor vibratorio e silencioso indicador de ajuste de potencia na maquina alavanca reguladora de nivel de corte e de textura sem trocar de lamina 220 v 60 hz lamina em aco inox a prova d'agua medindo 10 x 10 x 28 cm l x a x p pesando 500g plug bipolar com marca de identificacao do inmetro e pinos arredondados embalagem com identificacao do inmetro incluido 4 quatro pentes ajustaveis 3 6 10 13 mm 1 uma escova de limpeza 1 um oleo lubrificante 1 um pente de cabelo 1 um protetor de lamina e um manual em portugues com certificado de garant; servicos para  a  infraestrutura de tecnologia da informacaoe comunicacao tic  nao classificados em outros top;24;683;111;572
844;servico de desinfeccao quimica e limpeza geral de caixa d'agua e reservatorio d'agua no cem  jose inacio  rodovia de ligacao  mg 480 km 20  contenda quantitativo da unidade  1 caixas d'agua de fibra elevadas de 1000 l  1 reservatorio de fibra inferior de 5500 l  2 caixas d'agua de amianto elevadas de 1000 l e de 500 l unidade situada na zona rural a uma distancia de 30 km da sede da secretaria de educacao a cada execucao deverao ser emitidos os laudos tecnicos elaborados porprofissional devidamente registrado no conselho regional de quimica e no ministerio da saude conforme exigencia da portaria rdc n 21614 da vigilancia sanitaria  1 caixa d'agua de amianto elevada de 500 l; servicos do comercio por atacado prestado por comissao o contratode livrosrevistasperiodicos e artigos de escritori;24;682;116;566
970;turbidimetro de bancada equipamentos em conformidade com a portaria 5182004 do ministerio da saude modo de medicao ntu ebc nefelometrico abs%t ou cu faixa minima de 0 1000 ntu precisao  2% de leitura sensores para correcao de erros de cor agua aparelho microprocessado padroes prontos para facilitar calibracao gabinete livre de corrosao saida para computador tipo rs232 impressora embutida lampada de vida util minima 8800 horas indicador de leitura estavel calibracao automatica com 5 padroes alimentacao 110220 volt fonte de luz led ou lampada de tungstenio incluso minimo 5 cubetas padrao de turbidez 01 cubeta de amostra suporte para cubetas manual de instrucoes equipamento com garantia minima de 12 meses apresentar catalogo para analis; servicos do comercio por atacado prestado por comissao o contratode livrosrevistasperiodicos e artigos de escritori;24;743;116;627
404;caixa termica com termometro digital 45 litro caixa termica com termometro digital 45 litro traz em sua composicao o isolamento termico alem de ser leve atoxica e de facil higienizacao desenvolvida em modelo compacto de 45 litros possui alca rigida com trava de seguranca que impede a abertura acidental da tampa e permite total vedacao caixa termica com termometro externo que mede a temperatura atual maxima e minima do conteudo interno termometro de maxima e minima produzido em material de alta resistencia revestimento interno em poliuretano pu que auxilia no isolamento termico capacidade para 15 litros facil higienizacao temperatura externa atraves de cabo e sensor maxima e minima funcao ocof ima de fixacao em objetos metalicos resistencia a agu; servicos do comercio por atacado prestado por comissao o contratode livrosrevistasperiodicos e artigos de escritori;23;755;116;639
459;cone barril material cilindrico fabricado em polietileno de baixa densidade com protecao contra raios uv resistente a intemperies sol e chuva com 123 m de altura com 3 fitas adesivas refletivas de alta visibilidade de 7cm cada com rebaixo individual para a protecao das mesmas na parte superior possuir alca para facilitar o transporte e orificio para encaixe de pisca de advertencia externo ou interno sinalizador noturno base quadrada de 60 cm x 60 cm com area externa para personalizacao e area interna para encher com agua ou areia  na parte inferior possuir 4 elevacoes para passagem de agua peso do cone 70 kg na cor laranja devera ser impressa ou silkada a logomarca da transcon conforme padrao da autarqu; servicos do comercio por atacado prestado por comissao o contratode livrosrevistasperiodicos e artigos de escritori;23;712;116;596
72;acem moido  acem moido   carne bovina de segunda embalada em sacos resistentes com peso de 1kg produto com registro no sifima limpa resfriada a uma temperatura nao superior a 4 c apresentando no maximo 6  de gordura e 3  de agua sem cartilagem ou osso proveniente da moagem de animais sadios abatidos sob inspecao veterinaria a carne deve apresentarse livre de parasitos e de qualquer substancia contaminante que possa alterala ou encobrir alguma alteracao caracteristicas organolepticas devem estar todas normais nao sera permitida a obtencao do produto a partir de moagem de carnes oriundas da raspa de ossos e carne mecanicamente separada nao serao permitidos aditivos e coadjuvantes de tecnologia elaboracao necessario a apresentacao de certificado sanitario conforme legislacao vigente deve ter data de validade superior a 6 meses apos a data de entreg; servicos do comercio por atacado prestado por comissao o contratode livrosrevistasperiodicos e artigos de escritori;22;857;116;741
768;purificador de agua natural e gelada compressor 220v purificador de agua natural e gelada ligado a rede de agua tratada suporte para instalacao na parede duas torneiras ajuste de temperatura refrigeracao compressor refil tripla filtragem queretem particulas de barro areia ferrugem sedimentos reduz o cloro e elimina sabores e odores indesejaveis refil girou trocou gas 134a inofensivo a camada de ozonio reservatorio com nanotecnologia capacidade do reservatorio 3 litros depositode agua com serpentina externa caldeira em aco inox com resistencia tipo cinta externa boias de controle de nivel da agua e de seguranca  vazao 60 litroshora  voltagem 220 v  frequencia 60hz potencia 100watts cor branco garantia e segurancain metro 12 meses de garantia dimensao altura 4100cm largura 3200cm profundidade 3600 cm peso 13quil; servicos para  a  infraestrutura de tecnologia da informacaoe comunicacao tic  nao classificados em outros top;22;821;111;710
909;tinta acrilica fosca  cor l 110  linha fachada lata 18 litros  composicao agua resina 100  acrilica elastomerica em dispersao aquosa aditivos pigmentos isentos de metais pesados cargas minerais espessantes tensoativos fungicida e bactericida a base de isotiazolinonas voc  compostos organicos volateis  valor obtido atraves da norma europeia din en 118901 = 0  01 gl voc  compostos organicos volateis  valor obtido atraves da norma internacional astm d 396005 = 0  01 gl solidosmassa  valor obtido atraves da norma abnt nbr 153152005 = 48  59   solidosvolume = 34  45   densidade = 123  136 gcm3 ph  astm e70  metodo de teste padrao para ph de solucoes aquosas com o eletrodo de vidro = 80  110 atender a abnt nbr 117022010 embalagem rendimento m2demao = lata 18 l ate 275 m2; servicos do comercio por atacado prestado por comissao o contratode livrosrevistasperiodicos e artigos de escritori;22;775;116;659
227;alimento nutricional completo para nutricao enteral ou oral normocalorico na diluicao padrao sabor baunilha e morango  embalagem de 400 gramas tabela de dosagem 10 kcalml  caracteristica osmolalidade 350 mosmkg de agua ingredientes maltodextrina oleo girassol proteina isolada de soro de leite de vaca sacarose caseinato de potassio oleo de canola hidroxido de sodio carbomato de calcio cloreto de magnesio vitamina c taurina lcarnitina sulfato ferroso vitamina e sulfato de zinco vitamina a niacina pantotenato de calcio vitamina d sulfato de manganes vitamina b6  sulfato de cobre vitamina b1 vitamina b2 acido folico iodeto de potassio selenito de sodio cloreto de cromo molibdato de sodio vitamina k biotina vitamina b12 emulsificante lecitina de soja e aromatizante nao cotem gluten alergicos contem derivados de soja e leit; servicos para  a  infraestrutura de tecnologia da informacaoe comunicacao tic  nao classificados em outros top;21;829;111;718
515;eliptico mecanico individual azulverde claro melhora a flexibilidade dos membros inferiores quadril membros superiores e a funcao cardiorrespiratoria estrutura metalica equipamento produzido a partir de tubos e chapas em aco carbono de alta resistencia sob dimensoes de 2    1    1  e 38 com espessuras minimas de 200 mm  orificios tubulares extremidades superiores inferiores e moveis blindados em chapa 14 tornandoo insensivel a penetracao de agua  utilizando eixos macicos e usinados para rolamentos duplos  tipo zz  solda processo mig pintura submetido a tratamento especial de superficie para o metodo eletrostatico epox utilizando misturas de resinas em poliester de alta resistencia a meteorizacao componentes polipropileno e pvc flexivel parafusos aco zincado dimensoes altura 1492 mm  largura 800 mm  profundidade 1215 mm  peso 278 kg  area 097 m   ; servicos do comercio por atacado prestado por comissao o contratode livrosrevistasperiodicos e artigos de escritori;21;858;116;742
641;linguica tipo calabresa cozida e  defumadacarne suinasem ossoslimpapobre em gorduras e com baixo teor de condimentostemperada com especiarias naturais e embutida em envoltoris naturaispacotes de polietilenohermeticamente fechadosisenta de substancias que sejam improprias ao consumo e que alterem suas caracteristicase proibido o uso de cmscarne mecanicamente separadadevera apresentar parametros de acordo com a instrucao normativa ndeg 4 31 de marco de 2000 e ser entregue congeladaem embalagens originais de fabrica de 5 kg apresentando rotulo de acordo com a portaria ndeg 371 de 04 de setembro de 1997 com aspecto caracteristicocor propria sem manchas pardacentas ou everdadasodor e sabor proprio com adicao de agua ou gelo no maximo 3%devera ser entregue congeladaembalagem de 5 kgdeve possuir sifservico de inspecao federal ou imainstituto mineiro de agropecuaria 19644; servicos do comercio por atacado prestado por comissao o contratode livrosrevistasperiodicos e artigos de escritori;21;876;116;760
678;luva de protecao contra vibracao antivibratoria  caracteristicas as luvas sao especialmente formuladas com latex natural que possui excelente funcao antiderrapante e resistencia ao desgaste efetivamente evite a colisao e o aperto causados pela industria de manuseio e proteja totalmente suas maos o design da impressao de bloqueio e botao na parte de tras da mao pode efetivamente apertar o pulso e evitar que ele caia suporte para uso repetido conveniente para limpar basta enxaguar com agua secalo e colocar em um local ventilado apos o uso protecao ambiental seguro e nao poluente excelente desempenho respiravel ao usar martelo para bater e perfurar furos as luvas podem evitar danos causados por fortes vibracoes especificacao material latex cor mostrado como imagem quantidade 1 par comprimento 26 cm peso do pacote aprox 109g funcao antivibracao protecao contra impacto resistencia ao desg; servicos do comercio por atacado prestado por comissao o contratode livrosrevistasperiodicos e artigos de escritori;21;896;116;780
696;macarrao tipo espagueti c 500 g macarrao espagueti vitaminado nao fermentado obtido pelo amassamento da farinha de trigo especial com agua adicionada de ovos massa seca com ovos fabricada a partir de materias primas selecionadas sas limpas e de boa qualidade preparada com 3 ovos por quilo no minimo correspondente a 0045g de colesterol por quilo sem adicao de corantes tendo no maximo umidade de 13% livre de materia terrosa parasitas larvas e detritos animais e vegetais contendoa vitamina a complexo b nicotinamida pp e ferro ao serem postos em agua nao deverao turvala antes da coccao embalagem sacos de polietileno atoxico transparente reforcado de 500 g podera ser adicionado apenas corantes naturais as massas deverao trazer no rotulo a designacao expressa de sua natureza rotulagem nutricional obrigatoria devera ser entregue no maximo 30 dias apos o empacot; servicos do comercio por atacado prestado por comissao o contratode livrosrevistasperiodicos e artigos de escritori;21;866;116;750
842;servico de coquetel 1  composto por sucos 2 sabores refrigerantes agua mineral coquetel nao alcoolico salgadinhos sortidos frutas frios paes e pastas servico de garcom e preparo do ambiente c arranjos de tolhas de mesa cadeiras e material de servico e transporte de equipamento observacao p cada evento a contratada devera considerar o numero de 100 pessoas podendo somar os quantitativos em eventos c maior numero de pessoas presentescada evento tem a duracao maxima de 6 horaso buffet devera calcular a quantidade de cada alimnentacao e bebidas pelo numero de convidados especificados nos topicos de cada itemos vasilahames devem ser de louca ou vidro nao podendo ser descartaveisos talaheres deverao ser em inox nao podendo ser descartaveisdos servicos contratados de alinentacao e bebibdas as sobras deverao ser embaladas e entregues ao acontratantepara cada servico sera definido o cardapio nao sendo necessariamente tudo que esta descrit; servicos do comercio por atacado prestado por comissao o contratode livrosrevistasperiodicos e artigos de escritori;21;943;116;827
927;tinta latex acrilica lavavel premium acabamen tinta latex acrilica lavavel premium acabamento fosco suave cores variadas  18 litrosespecificacao tinta latex tipo acrilica lavavel desempenho premium com alta cobertura e resistencia e baixo respingamento a base de resina de copolimero estireno acrilico polimeros vinilicos pigmentos ativos cargas inertes coalescente espessastes tensoativos bactericidas e fungicidas aditivos e agua solvente a base de agua sem cheiro apos secar poder cobertura seca min de 6m2l e cobertura de tinta umida mn de 90% voc de 10 a 25 gl isenta de metais pesados solidos em volume 3043% acabamento fosco suave rendimento aproximado de 60m2l na para superficies externas e internas de reboco massa acrilica textura em concreto fibrocimento e internas de massa corrida e gesso devidamente preparado validade minima de 12 meses apos o receb; servicos do comercio por atacado prestado por comissao o contratode livrosrevistasperiodicos e artigos de escritori;21;865;116;749
940;torneira para tanque 14 de volta metal e destinada para aplicacao em tanques e tambem em areas externas de jardim ou quintal o produto e fabricado todo em metal tanto o corpo da torneira como a alavanca de abertura o sistema de fechamento e 14 de volta isso significa que voce ira abrir e fechar a torneira com movimento rapido e facil essa torneira acompanha um bico para encaixe de uma mangueira a instalacao e simples sera necessario passar um fita veda rosca  sempre no sentido horario na rosca da torneira e apos rosquear na sua saida de agua a torneira possui bitola de 12   mas acompanha adaptador para 34   o produto e fabricado no brasil e fornecemos assistencia tecnica e todas as pecas de reposicao material latao cromado de alta resistenciaacionamento 14 de voltabitola  12  mas acompanha adaptador 34 fixacao pared; servicos para  a  infraestrutura de tecnologia da informacaoe comunicacao tic  nao classificados em outros top;21;827;111;716
53;150203  fornecimento e instalacao de rodapes ceramica h = 10cm sera medido por comprimento de rodape colocado m o item remunera o fornecimento de rodape em placa ceramica esmaltada de primeira qualidade  classe a ou classe extra  conforme anexo a da nbr 13818 indicado para pisos internos sujeitos a lavagem frequente com as caracteristicas a dimensoes 10 x 30 cm b media absorcao de agua 3%< abs < 6% grupo biia  semigres   c resistencia quimica classe a  alta resistencia quimica a produtos domesticos e de piscinas  d resistencia ao manchamento classe de limpabilidade 5 e carga de ruptura > 1000 n f resistencia a abrasao superficial classe v pei5 g resistencia ao risco escala mohs > 5 h resistente a gretagem i resistente ao choque termico j coeficiente de atrito > 040  classe 2  remunera tambem o fornecimento de argamassa colante industrializada tipo aci e a maodeobra necessaria para a  execucao dos serv; servicos do comercio por atacado prestado por comissao o contratode livrosrevistasperiodicos e artigos de escritori;20;914;116;798
235;aparelho de anestesia aparelho de anestesia ventilacao micro processadaajuste digital para pressaoajuste digital para frequencia respiratoriaajuste digital de tempo inspiratoriopressao maxima obtida pela ventilacaopressao atual pulmonarrelacao inspiracao expiracaopossibilita ciclar por pressao volume e tempovaporizador ambar  ajustes para diferentes tipos de anestesicospeso 19kgdimensoes 43x130x46cmgarantia 2 anosbisturi eletronico bp 100 plus analogico com controle digital e independente das potencias para corte blend e coagulacao alarme de seguranca que bloqueia todos os circuitos em caso de rompimento do cabo da placa neutra saidas totalmente isoladas teclas totalmente blindadas e a prova de liquidos pedal contra penetracao nociva de agua ventilacao por convencao natural permite o uso de placa neutra simples descartavel sem uso de um acessorio especificopotencia de saidacorte 100 w carga 500 ohmsblend 60 w  carga 500ohm; servicos do comercio por atacado prestado por comissao o contratode livrosrevistasperiodicos e artigos de escritori;20;936;116;820
255;bebedouro eletrico acessivel  bebedouro eletrico tipo pressao acessivel para fixacao em parede com sistema de filtragem que inclua retencao de particulas piii e reducao de cloro cl dimensoes e capacidade altura maxima 625 mm largura maxima 465 mm profundidade maxima 490 mm fornecimento minimo de agua gelada 6 lh caracteristicas  pia em aco inox polido gabinete em aco inox ou chapa eletrozincada torneiras em latao cromado de facil e suave acionamento acionamento eletrico mediante botoes independentes para agua gelada e natural identificacao dos botoes com indicacao em texto e para leitura tatil braille duas torneiras em haste para copo com jato regulavel obs visando melhores condicoes de higiene para as criancas o bebedouro nao tera torneira tipo jato para bocareservatorio de agua em aco inox aisi 304 serpentina externa com isolamento termico previsoes para limpeza higienizacao e dreno mangueiras atox; servicos para  a  infraestrutura de tecnologia da informacaoe comunicacao tic  nao classificados em outros top;20;913;111;802
261;bebedouro industrial c 03 torneiras capacidade p 150 litros com regulagem de temperatura agua com temperatura ate 23oc e resfriada para faixa de 2oc a 7oc em tempo minimo tecnologia de isolamento em poliuretano acabamento externo em aco inoxidavel dentro do deposito para agua devera conter uma serpentina confeccionada em tubo de cobre com revestimento em pintura a po eletrostatica na cor branca unidade condensadora c baixo nivel de ruido e baixo consumo de energia com filtro de carvao ativo que remove impurezas residuos e odor da agua pia de escoamento em vacumform pes com regulagem de altura 2 torneiras metalicas para saida de agua com grande vazao padrao das torneiras 1 jardim2 pressao medidas profundidade com a pia 740mm altura 1520mm largura da base 715mm profundidade da base 560mm consumo de energia 127v 1890 kwhmes motor 14 cv eficiencia energetica 127v 0011 kwl capacidade de refrigeracao 127v 1100 lh certificado de acordo com a p; servicos do comercio por atacado prestado por comissao o contratode livrosrevistasperiodicos e artigos de escritori;20;950;116;834
458;composto lacteo adicionado de vitaminas minerais e fibras combinacao exclusiva de calcio proteina e vitamina d sem adicao de acucares rico em selenio vitamina d e b12 fonte de calcio fosforo zinco cobre vitaminas a e k c b1 b6 acido pantotenico e biotina e sem adicao de sacarose e de outros acucares* sem gluten  contem lactose contem fibras soluveis e sem sabor podendo ser reconstituido com agua ou ser adicionado ao final de receitas doces e salgadas  contem acucares proprios dos ingredientes desenvolvido para adultos maiores de 50 anos com necessidades de complementos nutricionais beneficios calcio e vitamina d auxiliam na manutencao de ossos fortes proteina contribui na manutencao dos musculos vitaminas b1 b2 b3 b5 b6 e biotina contribuem para uma producao e liberacao de energia zinco e vitamina c contribuem para o sistema imunologico ferro auxilia na formacao das celulas vermelhas caracteristicas tecnicas fonte de macronutrientes gorduras  31%; servicos do comercio por atacado prestado por comissao o contratode livrosrevistasperiodicos e artigos de escritori;20;960;116;844
502;detergente  aditivo alcalino para lavagem de roupas indicado como reforcador alcalino tanto na prelavagem como na lavagem de roupas quando associado a um detergente age de forma ideal em todas as sujidades principalmente com fluidos corporais e sujidades de oleos graxas e gorduras tem funcao de dilatar as fibras dos tecidos e abrir espaco para o detergente agir de forma mais eficiente  diluicao 0110  embalagem 50 litros  por se tratar de produto para diluicao em agua o fornecedor oferecera em comodato o dosador de produtos com opcoes de 15 processos de lavagem parametrizacao com 3 niveis de aga e automocao do processo atraves de bombas hidraulicas controle do nivel de agua na lavadora  e descarte de agua atraves de pistao pneumatico manutencoes preventivas e corretivas pontuais  sempre que solicitado sem custos ou taxas de deslocamento  exigencias quanto ao produto anvisa fispq fca de especificacao tecn; servicos para  a  infraestrutura de tecnologia da informacaoe comunicacao tic  nao classificados em outros top;20;916;111;805
529;filezinho de peito de frango frango semi  processado de qualidade peito partes inteiras sassami sem tempero  congeladas 18c  com odor sabor manchas e parasitas caracteristico  sem manchas e parasitas constando obrigatoriamente registro no mini isento da agricultura no sistema de inspecao federal ou sistema de inspecao estadual do lote a ser entregue so sera adquirido o produto se aprovado com indice de agua de no minimo 6  e so sera' adquirido se for aprovado com indice minimo de 85  deaceitabihdade conforme determinacao do fnde acondicionado em embalagem de 2 kg identificados plastica transparente atoxico resistente identificado 0 tipo do corte data da embalagem registro do produto de acordo com a legislacao vigente a came de frango devera ser transportada em carro fechado e refrigera do dentro de faixas plasticas higienicas do carro fechado e refrigerado o transporte devera ser em carro coberto e em caixas grandes de isopor minimo de 1701 comprimento 99 cm largu; servicos do comercio por atacado prestado por comissao o contratode livrosrevistasperiodicos e artigos de escritori;20;978;116;862
630;lavadora de alta pressao com motor a inducao  motor de inducao  bomba em aco inox com cabecote em latao  tubeira profisional  mangueira de alta pressao com trama de aco  mangueira de succao de detergente da maquina  porta acessorios  carrinhocom alca e rodas  pressao maxima 1556 psi  107 bar 110 volts  pressao nominal 1037 psi  72 bar 110 volts  vazao de agua 400 lmin 110v  potencia 1500 watts 110v  tamanho do cabo eletrico 5 m  voltagens 127v  peso sem acessorios 17 kg  medidas 570 x 320 x 330 mm c x l x a  mangueira de alta pressao de 75m com pistola  tubeira de alta pressao  carrinho com rodas  adaptador engate rapido obs uso na secretaria de agricultura meio ambiente desenvolvimento economico turismo e cultura localizada na rua cel eduardo amaral 236 centro e utilizacao exporadicamente na coleta seletiva  usina de triagem de materiais reciclaves localizada na rua sao jose n 1500 bairro jd ipe andradas mg; servicos do comercio por atacado prestado por comissao o contratode livrosrevistasperiodicos e artigos de escritori;20;921;116;805
666;locacao de caminhao pipa capacidade do tanque 10000 litros equipado com esguicho chuveirinho rabo de pavao e bomba de succao de agua 1ano de fabricacao a partir de 2010  2devera disponibilizar motorista e combustivel  3todas as despesas decorrentes de manutencao geral do veiculo pecas de reposicao pneus lavagem lubrificacao bem como motorista combustivel e seguro correrao por conta da empresa contratada assim como as despesas e responsabilidades perante as leis trabalhistas previdenciarias fiscais e outras de qualquer natureza proveniente deste instrumento  4 prazo de vigencia contratual 12 meses  5regime de pagamento horas trabalhadas  6quantidade estimada de horas mensal 200 horas em horarios diversos de acordo com a orientacao da secretaria de projetos e obras publicas  7pagamento sera mensal  8  periodo de segunda a sextafeira das 0700 horas as 1800 horas com intervalo para almoco e excepcionalmente nos finais de semana se houver necessidade  9 ; servicos do comercio por atacado prestado por comissao o contratode livrosrevistasperiodicos e artigos de escritori;20;963;116;847
737;pao de hot dog o pao devera estar embalado em sacos plastico transparente de maneira higienica e ordenados sem amassalos nao e permitido em hipotese alguma o armazenamento e transporte do mesmo em caixas de papelao o pao devera estar fresco novo no ato da entrega sera rejeitado o pao queimado ou mal cozido o pao deve ser fabricado com materias primas de primeira qualidade isentos de materia terrosa parasitos e em perfeito estado de conservacao e tambem deve ter tamanho padrao o pao de hot dog e o produto assado obtido pela coccao em condicoes tecnicas adequadas da massa preparada com farinha de trigo enriquecida com ferro e acido folico e agua sal fermento biologico o produto podera conter outras substancias alimenticiasaprovadas que o caracterizem as quais deverao ser citadas o preparo do pao tipo hot dog devera ser obtido pela coccao da massa apresentando casca fina e macia miolo elastico e homogeneo com poros finos o produto nao podera conter leite soro d; servicos do comercio por atacado prestado por comissao o contratode livrosrevistasperiodicos e artigos de escritori;20;972;116;856
807;reservatorio caixa d agua cilindro vertical com fundo conico  com 4 pes com altura padrao 500mm para reservacao de agua potavel fabricada em aco carbono minimo de 5mm resistente as acoes externas como sol chuva entre outros fabricadas de acordo com as normas abnt com estrutura de sustentacao e perfil enrijecido duplado de 200mm na chapa de 5mm com sapata de sustentacao na espessura de 16mm com furo para parafuso chumbador volume 50000 litros com escada interna e externaguarda corpo na escada externa e grade de seguranca no teto pintura da superficie interna realizada com aplicacao de fundo e acabamento em epoxi de poliamida atoxico e anti corrosivo de alta impermeabilidade na cor azul piscina com certificado de potabilidade com espessura final de 180 a 200 microns com certificado de potabilidade pintura da superficie externa realizada com aplicacao de fundo primer epoxi eacabamento em epoxi pu atoxico e anti corrosivo de alta impermeabilidade na c; servicos para  a  infraestrutura de tecnologia da informacaoe comunicacao tic  nao classificados em outros top;20;961;111;850
843;servico de cronometragem servico de cronometragem eletronica a ser realizado nos eventos de corridas de rua trail running e ciclismo conforme detalhadamento do servico que segue abaixo 01 tapete ou similar antenas de 25 metros carregadores e cabos de rede 200 unidades de numeros de peito e chip descartavel identificador de atletas para as corridas de rua 300 unidades de numeros de peito e chip descartavel identificadores de atletas para trail running e  200 unidades de numeros de peito e chip descartavel identificador de atletas para eventos de ciclismo em alta resolucao em policromia e cores material super resistente e a prova d'agua com os alfinetes ou com abracadeiras dependendo do evento picotes de guarda volumes e outros unidades de chip descataveis inclusos de acordo com a quantidade e evento mencionado acima corrida de rua trail running e ciclismo de precisao com caracteristica de cartao e com o operador do equipamento incluso 01 relogio de duas fac; servicos do comercio por atacado prestado por comissao o contratode livrosrevistasperiodicos e artigos de escritori;20;970;116;854
260;bebedouro industrial 100 litros inox 4 torneiras bebedouro industrial 100 litros inox 4  torneiras  o bebedouro industrial100 litros 4 torneiras  e um aparelho de grande porte apoiado sobre o piso com  grande capacidade de atendimento e refrigeracao podendo  atender ate quatro usuarios simultaneamente ideal para  ambientes de grande fluxo de pessoas robusto e de  design moderno atende com eficiencia ambientes como  por exemplo grandes academias clubes industrias  empresas escola fabrica galpao igreja oficina hospital  posto de combustivel tratase de aparelho de porte  grande robusto e de grande capacidade de fornecimento  de agua gelada e natural atendendo ate 4 pessoas  simultaneamente  possui gabinete em chapa de aco inox  escovado  fornece agua atraves de quatro torneiras  disponiveis sendo uma em cada face lateral direita e  esquerda e duas na face frontal  possui termostato  automatico e interno mantendo a temperatura sempre ideal  para o consumo  sua cap; servicos para  a  infraestrutura de tecnologia da informacaoe comunicacao tic  nao classificados em outros top;19;974;111;863
734;palco 10x10 metros estrutura do teto toda trelicada galvanizada em otimo estado de conservacao piso antiderrapante modular de sistema roseta e garra andaime desmontavel com altura minima de 170 metros do nivel do chao diaria 25que pode variar ate 270 metrosse houver desnivel do terreno coberto com lona de vinil auto extinguivel na cor branca 02 camarins de no minimo 440m x 440m todo fechado com chapa de lambril galvanizada na mesma altura do nivel do piso do palco 02 areas de servico nas laterais do palco de 220m x 440m toda fechada com lona branca na mesma altura do nivel do pal co 01 housemix com 1o piso 45cm elevado do nivel do chao no tamanho de 220m x 440m com opcao de montagem em 2 pisos 02 torres de fly de 240m x 240m x 8 metros os camarins as areas e a house mix deverao ser cobertas com tendas modelo chapeu de bruxa com autoextinguiveis na cor branca e calha nas lateriais para o escoamento de agua a locacao acima de 02 dias tera um descon; servicos para  a  infraestrutura de tecnologia da informacaoe comunicacao tic  nao classificados em outros top;19;960;111;849
769;purificador de agua para parede possui ainda opcoes de agua em temperatura natural e gelada refil  girou trocou  e nanotecnologia conta microorganismos compacto ele pode ser fixado na parede ou em bancadas   caracteristica ecocompressor com gas r134a que nao agride o meio ambiente agua filtrada sem energia refil girou trocou troque sem fechar o registro refil bacteriostatico controla a proliferacao de bacterias elimina odores elimina sabores retem microparticulas presentes na agua eas y clean 9 desmontavel para higienizacao serpentina externa facil higienizacao nanotecnologia inibe a proliferacao de microorganismos bandeja removivel para esvaziar ou higienizar torneira pratica fixacao na parede pes antiderrapantes boia de controle de nivel de agua volume interno do aparelho 218 litros capacidade de fornecimento de agua gelada 124 lh tipo de refrigeracao compressor etapas de purificacao 3 vida util do filtro 3000 l potencia 90w consumo 11 kwh; servicos para  a  infraestrutura de tecnologia da informacaoe comunicacao tic  nao classificados em outros top;19;955;111;844
904;termometro infravermelho digital de testa alta precisao sem contato com a pele com leitura em 1 segundo   termometro infravermelho digital de testa alta precisao sem contato com a pele com leitura em 1 segundo  termometro com visor retroiluminado e aviso de temperatura elevada desliga automaticamente apos 17s para economizar no uso de energia possui dois modos de medicao temperatura de superficie e temperatura corporal facil utilizacao com 1 botao e pratico para triagem por temperatura em locais publicos e empresas   mede temperatura corporal de 32  a 43 c e temperatura de superficies de 0  a 100   precisao para temperatura corporal  02 c | temperatura de superficie  03 c   pode ser utilizado para medir a temperatura da agua do banho e outros objetos  higienico e portatil e otimo para ser compartilhado pela familia sem risco de contaminacao  excelente para medicao de temperatura infantil sem incomodar o bebe  distancia para leitura 2 a 15cm   alarme de febre ajustav; servicos do comercio por atacado prestado por comissao o contratode livrosrevistasperiodicos e artigos de escritori;19;980;116;864
